AccumulateCovid19,areaNm,increase,AccumulateReleased,localIncrease,CovidForeigner,baseYmd
6923,울산광역시,50,6371,50,0,2022-01-01
2158,세종특별자치시,16,1957,16,0,2022-01-01
11602,충청북도,104,10540,103,1,2022-01-01
4661,제주특별자치도,23,4446,22,1,2022-01-01
9653,전라북도,85,8249,84,1,2022-01-01
187754,경기도,1391,147229,1359,32,2022-01-01
25287,부산광역시,212,21163,210,2,2022-01-01
226698,서울특별시,1464,177348,1429,35,2022-01-01
12315,대전광역시,65,10584,64,1,2022-01-01
20840,경상남도,162,18366,162,0,2022-01-01
15431,경상북도,116,13456,114,2,2022-01-01
25503,부산광역시,216,21539,214,2,2022-01-02
4680,제주특별자치도,19,4464,18,1,2022-01-02
20981,경상남도,141,18520,136,5,2022-01-02
8211,광주광역시,93,7410,93,0,2022-01-02
189031,경기도,1277,147387,1244,33,2022-01-02
9732,전라북도,79,8369,76,3,2022-01-02
15525,경상북도,94,13547,94,0,2022-01-02
2170,세종특별자치시,12,1974,12,0,2022-01-02
21113,경상남도,132,18808,129,3,2022-01-03
228867,서울특별시,993,178481,964,29,2022-01-03
12577,강원도,54,11420,50,4,2022-01-03
189948,경기도,917,147546,894,23,2022-01-03
18449,충청남도,115,16136,115,0,2022-01-03
8286,광주광역시,75,7458,73,2,2022-01-03
18563,충청남도,114,16252,110,4,2022-01-04
229801,서울특별시,938,180705,903,35,2022-01-04
9910,전라북도,92,8630,89,3,2022-01-04
21229,경상남도,117,19075,112,5,2022-01-04
37553,인천광역시,171,32995,162,9,2022-01-04
4726,제주특별자치도,18,4502,17,1,2022-01-04
15636,경상북도,62,14005,59,3,2022-01-04
12457,대전광역시,34,10810,31,3,2022-01-04
6249,전라남도,46,5554,42,4,2022-01-04
190895,경기도,947,155491,916,31,2022-01-04
11760,충청북도,61,10858,61,0,2022-01-04
18702,충청남도,139,16390,137,2,2022-01-05
192362,경기도,1467,155812,1416,51,2022-01-05
8422,광주광역시,75,7593,73,2,2022-01-05
11828,충청북도,68,10950,67,1,2022-01-05
37824,인천광역시,271,33246,261,10,2022-01-05
10007,전라북도,97,8736,93,4,2022-01-05
12709,강원도,69,11706,68,1,2022-01-05
12508,대전광역시,51,10923,41,10,2022-01-05
38107,인천광역시,283,33480,273,10,2022-01-06
15822,경상북도,89,14322,88,1,2022-01-06
12549,대전광역시,41,11004,38,3,2022-01-06
12766,강원도,57,11840,54,3,2022-01-06
6368,전라남도,59,5661,57,2,2022-01-06
21446,경상남도,103,19515,101,2,2022-01-06
2226,세종특별자치시,18,2058,18,0,2022-01-06
4788,제주특별자치도,19,4544,16,3,2022-01-06
38288,인천광역시,181,33717,172,9,2022-01-07
15931,경상북도,109,14426,104,5,2022-01-07
8600,광주광역시,87,7763,87,0,2022-01-07
23838,대구광역시,99,22193,95,4,2022-01-07
2240,세종특별자치시,14,2074,14,0,2022-01-07
10162,전라북도,84,8920,78,6,2022-01-07
18897,충청남도,116,16618,108,8,2022-01-07
195149,경기도,1261,156249,1224,37,2022-01-07
7169,울산광역시,38,6644,33,5,2022-01-07
233457,서울특별시,1038,187191,979,59,2022-01-07
4807,제주특별자치도,9,4583,6,3,2022-01-08
10229,전라북도,67,9012,64,3,2022-01-08
7196,울산광역시,27,6701,27,0,2022-01-08
12016,충청북도,53,11149,51,2,2022-01-08
18993,충청남도,96,16718,93,3,2022-01-08
234449,서울특별시,994,188072,933,61,2022-01-08
16016,경상북도,85,14512,82,3,2022-01-08
26692,부산광역시,181,23526,173,8,2022-01-08
12937,강원도,81,12008,77,4,2022-01-08
8689,광주광역시,89,7866,87,2,2022-01-08
7230,울산광역시,34,6741,31,3,2022-01-09
4818,제주특별자치도,11,4604,8,3,2022-01-09
10305,전라북도,76,9116,71,5,2022-01-09
24054,대구광역시,108,22458,105,3,2022-01-09
16109,경상북도,93,14556,89,4,2022-01-09
235415,서울특별시,966,189400,891,75,2022-01-09
8781,광주광역시,92,7971,88,4,2022-01-09
12665,대전광역시,40,11243,35,5,2022-01-09
12050,충청북도,34,11224,32,2,2022-01-09
13014,강원도,77,12081,70,7,2022-01-09
21746,경상남도,98,20124,86,12,2022-01-09
198485,경기도,1014,165767,982,32,2022-01-10
13074,강원도,60,12151,56,4,2022-01-10
10401,전라북도,96,9252,93,3,2022-01-10
16197,경상북도,88,14633,79,9,2022-01-10
4831,제주특별자치도,13,4624,8,5,2022-01-10
10459,전라북도,58,9346,55,3,2022-01-11
19307,충청남도,105,17059,98,7,2022-01-11
199600,경기도,1115,165992,1055,60,2022-01-11
38955,인천광역시,154,34498,140,14,2022-01-11
4846,제주특별자치도,15,4645,13,2,2022-01-11
2294,세종특별자치시,16,2147,15,1,2022-01-11
24218,대구광역시,71,22697,66,5,2022-01-11
13162,강원도,88,12214,85,3,2022-01-11
236946,서울특별시,755,191317,670,85,2022-01-11
7275,울산광역시,22,6823,17,5,2022-01-11
21918,경상남도,92,20486,84,8,2022-01-11
7302,울산광역시,27,6888,27,0,2022-01-12
12831,대전광역시,90,11545,81,9,2022-01-12
22037,경상남도,119,20637,112,7,2022-01-12
19422,충청남도,115,17151,112,3,2022-01-12
10517,전라북도,58,9556,58,0,2022-01-12
12202,충청북도,68,11443,66,2,2022-01-12
201227,경기도,1629,166188,1567,62,2022-01-12
16334,경상북도,77,14949,72,5,2022-01-12
7038,전라남도,164,5884,160,4,2022-01-12
238039,서울특별시,1093,191317,973,120,2022-01-12
9248,광주광역시,158,8164,158,0,2022-01-12
13279,강원도,117,12288,113,4,2022-01-12
16433,경상북도,99,14975,92,7,2022-01-13
39456,인천광역시,240,34847,224,16,2022-01-13
12263,충청북도,61,11491,58,3,2022-01-13
7174,전라남도,136,5884,133,3,2022-01-13
22152,경상남도,115,20757,94,21,2022-01-13
27456,부산광역시,162,24812,156,6,2022-01-13
2315,세종특별자치시,7,2172,6,1,2022-01-13
24436,대구광역시,125,22883,119,6,2022-01-13
4858,제주특별자치도,7,4687,7,0,2022-01-13
204618,경기도,1856,166568,1784,72,2022-01-14
9660,광주광역시,224,8221,224,0,2022-01-14
12333,충청북도,71,11565,67,4,2022-01-14
239950,서울특별시,939,194347,835,104,2022-01-14
4864,제주특별자치도,6,4687,3,3,2022-01-14
27583,부산광역시,127,24987,121,6,2022-01-14
2323,세종특별자치시,8,2183,8,0,2022-01-14
22278,경상남도,126,20875,117,9,2022-01-14
206441,경기도,1823,166811,1761,62,2022-01-15
19779,충청남도,121,17186,110,11,2022-01-15
13018,대전광역시,53,11704,49,4,2022-01-15
12416,충청북도,83,11618,77,6,2022-01-15
27726,부산광역시,143,25141,135,8,2022-01-15
9866,광주광역시,207,8382,205,2,2022-01-15
24651,대구광역시,126,23088,118,8,2022-01-15
16621,경상북도,95,15152,85,10,2022-01-15
7462,전라남도,155,5885,151,4,2022-01-15
10847,전라북도,123,9854,120,3,2022-01-15
22394,경상남도,116,20981,108,8,2022-01-15
4885,제주특별자치도,8,4773,5,3,2022-01-16
27871,부산광역시,145,25377,137,8,2022-01-16
12455,충청북도,39,11646,37,2,2022-01-16
7405,울산광역시,19,7045,15,4,2022-01-16
7630,전라남도,169,5885,160,9,2022-01-16
22517,경상남도,123,21087,112,11,2022-01-16
2359,세종특별자치시,21,2217,20,1,2022-01-16
13744,강원도,79,12542,73,6,2022-01-17
13154,대전광역시,82,11733,79,3,2022-01-17
24984,대구광역시,176,23281,171,5,2022-01-17
209454,경기도,1427,167192,1351,76,2022-01-17
7935,전라남도,139,5885,138,1,2022-01-18
16962,경상북도,138,15281,129,9,2022-01-18
13262,대전광역시,108,11809,101,7,2022-01-18
40625,인천광역시,196,35422,177,19,2022-01-18
10475,광주광역시,184,8523,174,10,2022-01-18
2388,세종특별자치시,23,2242,21,2,2022-01-18
7459,울산광역시,35,7107,33,2,2022-01-18
22778,경상남도,142,21299,134,8,2022-01-18
28102,부산광역시,114,25796,102,12,2022-01-18
13986,강원도,148,12657,146,2,2022-01-19
41049,인천광역시,424,35746,401,23,2022-01-19
2414,세종특별자치시,26,2257,26,0,2022-01-19
22979,경상남도,201,21402,183,18,2022-01-19
7503,울산광역시,44,7137,44,0,2022-01-19
12636,충청북도,81,11803,79,2,2022-01-19
20325,충청남도,183,17415,173,10,2022-01-19
10701,광주광역시,226,8523,218,8,2022-01-19
8089,전라남도,154,5885,143,11,2022-01-19
215578,경기도,2418,167839,2364,54,2022-01-20
2423,세종특별자치시,9,2272,9,0,2022-01-20
11526,전라북도,138,10255,131,7,2022-01-20
14097,강원도,111,12713,107,4,2022-01-20
11055,광주광역시,354,8523,350,4,2022-01-20
4923,제주특별자치도,10,4817,9,1,2022-01-20
20542,충청남도,217,17568,208,9,2022-01-20
17358,경상북도,226,15392,220,6,2022-01-20
25732,대구광역시,364,23591,355,9,2022-01-20
7575,울산광역시,72,7155,69,3,2022-01-20
13587,대전광역시,111,11936,111,0,2022-01-21
4938,제주특별자치도,15,4833,10,5,2022-01-21
7657,울산광역시,82,7155,78,4,2022-01-21
8448,전라남도,199,5885,198,1,2022-01-21
28711,부산광역시,216,26336,207,9,2022-01-21
12898,충청북도,87,11903,85,2,2022-01-21
26120,대구광역시,388,23661,386,2,2022-01-21
247475,서울특별시,1552,202458,1485,67,2022-01-21
17592,경상북도,234,15392,225,9,2022-01-21
4955,제주특별자치도,18,4838,17,1,2022-01-22
17799,경상북도,207,15422,198,9,2022-01-22
28947,부산광역시,236,26458,231,5,2022-01-22
42489,인천광역시,571,36268,542,29,2022-01-22
11549,광주광역시,252,9136,246,6,2022-01-22
23610,경상남도,220,21684,215,5,2022-01-22
2452,세종특별자치시,12,2298,12,0,2022-01-22
249065,서울특별시,1591,202559,1535,56,2022-01-22
13865,대전광역시,159,12019,151,8,2022-01-23
7799,울산광역시,91,7219,84,7,2022-01-23
23836,경상남도,226,21786,213,13,2022-01-23
13158,충청북도,110,12015,108,2,2022-01-23
27022,대구광역시,458,23859,448,10,2022-01-23
12002,전라북도,140,10491,136,4,2022-01-23
2476,세종특별자치시,24,2305,23,1,2022-01-23
11865,광주광역시,316,9172,306,10,2022-01-23
12151,광주광역시,286,9321,278,8,2022-01-24
12202,전라북도,200,10587,192,8,2022-01-24
43680,인천광역시,582,36665,552,30,2022-01-24
9004,전라남도,206,5885,196,10,2022-01-24
7868,울산광역시,69,7249,65,4,2022-01-24
29537,부산광역시,298,26838,287,11,2022-01-24
14023,대전광역시,158,12019,153,5,2022-01-24
29880,부산광역시,343,26966,332,11,2022-01-25
12466,광주광역시,315,9321,315,0,2022-01-25
12440,전라북도,238,10706,232,6,2022-01-25
18529,경상북도,281,15560,275,6,2022-01-25
27990,대구광역시,489,24079,483,6,2022-01-25
7969,울산광역시,101,7265,96,5,2022-01-25
14711,강원도,165,13189,153,12,2022-01-25
21718,충청남도,311,18154,304,7,2022-01-25
228505,경기도,2917,169224,2869,48,2022-01-25
2578,세종특별자치시,69,2332,69,0,2022-01-25
24414,경상남도,344,22027,341,3,2022-01-25
9481,전라남도,286,5886,284,2,2022-01-26
232726,경기도,4221,169459,4184,37,2022-01-26
2655,세종특별자치시,77,2352,76,1,2022-01-26
13676,충청북도,247,12173,243,4,2022-01-26
30443,부산광역시,563,27126,548,15,2022-01-26
14874,강원도,163,13235,158,5,2022-01-26
12862,광주광역시,396,9504,392,4,2022-01-26
24956,경상남도,542,22137,531,11,2022-01-26
14619,대전광역시,370,12045,366,4,2022-01-26
12741,전라북도,301,10817,293,8,2022-01-26
5159,제주특별자치도,72,4884,69,3,2022-01-27
13052,전라북도,311,10970,308,3,2022-01-27
19463,경상북도,489,15654,480,9,2022-01-27
31184,부산광역시,741,27304,732,9,2022-01-27
15032,대전광역시,413,12103,408,5,2022-01-27
13433,전라북도,381,11152,369,12,2022-01-28
23110,충청남도,536,18337,533,3,2022-01-28
26219,경상남도,603,22612,595,8,2022-01-28
30296,대구광역시,866,24964,862,4,2022-01-28
264748,서울특별시,3991,211182,3946,45,2022-01-28
14269,충청북도,299,12361,297,2,2022-01-28
32005,부산광역시,821,27484,813,8,2022-01-28
13991,전라북도,559,11323,558,1,2022-01-29
2832,세종특별자치시,43,2408,42,1,2022-01-29
268947,서울특별시,4199,212591,4166,33,2022-01-29
26916,경상남도,697,22612,691,6,2022-01-29
23627,충청남도,517,18337,508,9,2022-01-29
2908,세종특별자치시,76,2422,74,2,2022-01-30
14930,충청북도,351,12719,347,4,2022-01-30
14526,광주광역시,477,10364,469,8,2022-01-30
16280,대전광역시,450,12452,442,8,2022-01-30
254003,경기도,5711,171103,5662,49,2022-01-30
273132,서울특별시,4185,213391,4157,28,2022-01-30
51656,인천광역시,1226,38920,1209,17,2022-01-31
11029,전라남도,293,5886,284,9,2022-01-31
34435,부산광역시,771,28172,764,7,2022-01-31
14942,전라북도,530,11519,524,6,2022-01-31
28299,경상남도,754,23153,741,13,2022-01-31
34030,대구광역시,967,26555,954,13,2022-02-01
3094,세종특별자치시,108,2454,108,0,2022-02-01
22393,경상북도,619,15894,614,5,2022-02-01
15526,전라북도,586,11724,583,3,2022-02-01
25700,충청남도,730,18337,720,10,2022-02-01
281456,서울특별시,4131,215045,4103,28,2022-02-01
9291,울산광역시,254,7584,250,4,2022-02-01
16588,강원도,354,14224,350,4,2022-02-02
36681,부산광역시,1267,28616,1260,7,2022-02-02
285665,서울특별시,4209,215801,4186,23,2022-02-02
16182,전라북도,656,11933,648,8,2022-02-02
3234,세종특별자치시,140,2495,139,1,2022-02-02
16126,광주광역시,618,10521,614,4,2022-02-02
54437,인천광역시,1400,40061,1396,4,2022-02-02
270695,경기도,6050,172082,6018,32,2022-02-02
37961,부산광역시,1280,29022,1273,7,2022-02-03
36432,대구광역시,1256,27721,1253,3,2022-02-03
30967,경상남도,910,23557,902,8,2022-02-03
18227,대전광역시,559,12749,555,4,2022-02-03
55971,인천광역시,1535,40812,1533,2,2022-02-03
290883,서울특별시,5218,217006,5191,27,2022-02-03
27505,충청남도,917,18338,908,9,2022-02-03
3372,세종특별자치시,138,2543,137,1,2022-02-03
9861,울산광역시,270,7736,270,0,2022-02-03
38145,대구광역시,1713,28363,1707,6,2022-02-04
18193,전라북도,1064,12399,1063,1,2022-02-04
13010,전라남도,648,6590,642,6,2022-02-04
17649,광주광역시,829,10768,826,3,2022-02-04
57754,인천광역시,1783,40812,1779,4,2022-02-04
17693,강원도,636,14545,632,4,2022-02-04
284478,경기도,7226,172509,7202,24,2022-02-04
25249,경상북도,1144,15909,1140,4,2022-02-04
18990,대전광역시,763,12861,757,6,2022-02-04
10332,울산광역시,471,7798,471,0,2022-02-04
3624,세종특별자치시,252,2616,248,4,2022-02-04
39686,부산광역시,1725,29454,1719,6,2022-02-04
297043,서울특별시,6160,219023,6139,21,2022-02-04
41617,부산광역시,1931,29917,1930,1,2022-02-05
19476,전라북도,1283,12723,1272,11,2022-02-05
305641,서울특별시,8598,220490,8564,34,2022-02-05
18128,충청북도,776,13933,771,5,2022-02-05
18391,강원도,698,14732,691,7,2022-02-05
39787,대구광역시,1642,29203,1637,5,2022-02-05
13975,전라남도,965,6590,962,3,2022-02-05
20022,대전광역시,1032,13054,1027,5,2022-02-05
294927,경기도,10449,172642,10419,30,2022-02-05
10835,울산광역시,503,7914,503,0,2022-02-05
20486,전라북도,1012,12994,1010,2,2022-02-06
4189,세종특별자치시,270,2742,269,1,2022-02-06
19177,강원도,786,14898,783,3,2022-02-06
31263,충청남도,1526,18569,1520,6,2022-02-06
43791,부산광역시,2174,30457,2168,6,2022-02-06
28488,경상북도,1750,16454,1741,9,2022-02-06
313462,서울특별시,7821,222044,7778,43,2022-02-06
19081,충청북도,953,14152,950,3,2022-02-06
11406,울산광역시,571,8036,571,0,2022-02-06
20079,광주광역시,1186,11368,1180,6,2022-02-06
35277,경상남도,1763,25082,1750,13,2022-02-06
313462,서울특별시,6888,320343,6873,15,2022-02-07
316684,경기도,9805,316684,9780,25,2022-02-07
16300,전라남도,1133,6921,1129,4,2022-02-07
28488,경상북도,1686,30174,1684,2,2022-02-07
316684,경기도,9805,173276,9780,25,2022-02-07
306879,경기도,9805,316684,9780,25,2022-02-07
30174,경상북도,1686,16455,1684,2,2022-02-07
32736,충청남도,1473,32736,1467,6,2022-02-07
21212,대전광역시,969,22181,968,1,2022-02-07
6544,제주특별자치도,369,6913,368,1,2022-02-07
22181,대전광역시,969,13096,968,1,2022-02-07
6913,제주특별자치도,369,6913,368,1,2022-02-07
43726,대구광역시,1971,30877,1967,4,2022-02-07
320343,서울특별시,6888,320343,6873,15,2022-02-07
64867,인천광역시,2376,64867,2366,10,2022-02-07
4451,세종특별자치시,262,4451,261,1,2022-02-07
19916,강원도,740,15079,738,2,2022-02-07
30174,경상북도,1686,30174,1684,2,2022-02-07
45718,부산광역시,1927,31126,1916,11,2022-02-07
19916,강원도,740,19916,738,2,2022-02-07
21288,광주광역시,1209,11548,1205,4,2022-02-07
45515,대구광역시,1789,31794,1788,1,2022-02-08
326253,서울특별시,5910,233080,5901,9,2022-02-08
4695,세종특별자치시,244,2880,243,1,2022-02-08
31718,경상북도,1545,16528,1543,2,2022-02-08
328822,경기도,12138,173517,12123,15,2022-02-08
17315,전라남도,1015,6922,1015,0,2022-02-08
20654,강원도,738,15322,736,2,2022-02-08
18443,전라남도,1128,6922,1125,3,2022-02-09
47930,대구광역시,2415,31880,2415,0,2022-02-09
21600,강원도,946,15579,942,4,2022-02-09
40797,경상남도,1947,27143,1943,4,2022-02-09
4982,세종특별자치시,287,2961,285,2,2022-02-09
33676,경상북도,1958,16530,1953,5,2022-02-09
24254,대전광역시,1130,13458,1128,2,2022-02-09
53305,부산광역시,2631,32575,2630,1,2022-02-10
23224,충청북도,1082,15403,1081,1,2022-02-10
25459,광주광역시,1427,12414,1422,5,2022-02-10
22564,강원도,964,15924,962,2,2022-02-10
8154,제주특별자치도,448,5692,448,0,2022-02-10
5255,세종특별자치시,273,3165,272,1,2022-02-10
26316,전라북도,1771,14916,1754,17,2022-02-10
360224,경기도,17751,215650,17738,13,2022-02-10
35494,경상북도,1818,18093,1813,5,2022-02-10
25704,대전광역시,1450,13835,1447,3,2022-02-10
14023,울산광역시,732,8929,732,0,2022-02-10
23651,강원도,1087,16674,1083,4,2022-02-11
56316,부산광역시,3011,32581,3007,4,2022-02-11
8630,제주특별자치도,476,5931,474,2,2022-02-11
39209,충청남도,1587,19907,1585,2,2022-02-11
52756,대구광역시,2497,35374,2497,0,2022-02-11
26867,광주광역시,1408,12848,1405,3,2022-02-11
5587,세종특별자치시,332,3513,332,0,2022-02-11
45330,경상남도,2192,27917,2186,6,2022-02-11
79521,인천광역시,3745,48514,3740,5,2022-02-11
37420,경상북도,1926,18197,1924,2,2022-02-11
394141,경기도,15960,222460,15952,8,2022-02-12
41396,충청남도,2187,19907,2185,2,2022-02-12
28443,광주광역시,1576,13011,1573,3,2022-02-12
374534,서울특별시,13198,243761,13189,9,2022-02-12
59367,부산광역시,3051,33688,3049,2,2022-02-12
29371,전라북도,1548,16037,1546,2,2022-02-12
16349,울산광역시,805,10364,805,0,2022-02-13
26868,충청북도,1331,18460,1321,10,2022-02-13
29983,광주광역시,1540,13011,1537,3,2022-02-13
6297,세종특별자치시,384,3983,383,1,2022-02-13
411215,경기도,17074,222819,17065,9,2022-02-13
23575,전라남도,1181,6926,1181,0,2022-02-13
25595,강원도,985,18446,981,4,2022-02-13
62809,부산광역시,3442,33688,3440,2,2022-02-13
31747,대전광역시,1614,14066,1613,1,2022-02-14
6650,세종특별자치시,353,4315,351,2,2022-02-14
397957,서울특별시,11599,247705,11595,4,2022-02-14
60302,대구광역시,2606,40593,2606,0,2022-02-14
43223,경상북도,1917,18408,1906,11,2022-02-14
52497,경상남도,2806,33281,2794,12,2022-02-14
17025,울산광역시,676,10957,676,0,2022-02-14
92642,인천광역시,3578,49130,3576,2,2022-02-14
32602,전라북도,1591,17804,1585,6,2022-02-14
31522,광주광역시,1539,13239,1536,3,2022-02-14
28410,충청북도,1542,19191,1541,1,2022-02-14
427088,경기도,15875,228937,15866,9,2022-02-14
10195,제주특별자치도,509,6990,509,0,2022-02-14
410410,서울특별시,12453,249872,12402,51,2022-02-15
33130,광주광역시,1608,13339,1599,9,2022-02-15
44988,경상북도,1765,18409,1755,10,2022-02-15
444328,경기도,17241,229140,17236,5,2022-02-15
55268,경상남도,2771,33281,2765,6,2022-02-15
33324,대전광역시,1577,14120,1575,2,2022-02-15
10746,제주특별자치도,551,7330,551,0,2022-02-15
31938,충청북도,2203,21124,2201,2,2022-02-16
75902,부산광역시,6483,37362,6483,0,2022-02-16
28070,전라남도,1930,6928,1930,0,2022-02-16
472291,경기도,27963,229341,27954,9,2022-02-16
11669,제주특별자치도,924,7982,924,0,2022-02-16
19560,울산광역시,1759,12421,1759,0,2022-02-16
66854,대구광역시,4190,44976,4190,0,2022-02-16
12551,제주특별자치도,882,8470,882,0,2022-02-17
50753,경상북도,2901,18804,2898,3,2022-02-17
21251,울산광역시,1691,13096,1691,0,2022-02-17
39317,전라북도,2574,21648,2567,7,2022-02-17
71053,대구광역시,4199,46820,4199,0,2022-02-17
41593,대전광역시,2980,15391,2980,0,2022-02-18
33311,강원도,1932,21045,1927,5,2022-02-18
54038,경상북도,3285,18929,3281,4,2022-02-18
9119,세종특별자치시,703,5248,703,0,2022-02-18
117944,인천광역시,7344,55687,7342,2,2022-02-18
537249,경기도,36511,229701,36507,4,2022-02-18
88698,부산광역시,6577,41118,6574,3,2022-02-18
36661,충청북도,2554,23216,2552,2,2022-02-18
43450,광주광역시,2741,13489,2740,1,2022-02-19
497821,서울특별시,23193,263206,23135,58,2022-02-19
25029,울산광역시,1832,14474,1832,0,2022-02-19
125758,인천광역시,7816,58915,7816,0,2022-02-19
95234,부산광역시,6536,41124,6534,2,2022-02-19
33773,전라남도,1900,6931,1898,2,2022-02-19
61527,충청남도,4077,21292,4072,5,2022-02-19
79811,대구광역시,4223,51126,4223,0,2022-02-19
16102,제주특별자치도,1231,10083,1231,0,2022-02-20
10454,세종특별자치시,658,5774,657,1,2022-02-20
41367,충청북도,2312,25167,2302,10,2022-02-20
26948,울산광역시,1919,15214,1919,0,2022-02-20
84518,대구광역시,4707,54468,4707,0,2022-02-20
47735,대전광역시,3110,16331,3106,4,2022-02-20
46111,광주광역시,2661,13533,2656,5,2022-02-20
599219,경기도,31328,230010,31326,2,2022-02-20
37109,강원도,1999,22595,1990,9,2022-02-20
142312,인천광역시,7364,67810,7362,2,2022-02-21
28541,울산광역시,1593,16449,1593,0,2022-02-21
83372,경상남도,5045,40611,5038,7,2022-02-21
68188,충청남도,3313,21792,3313,0,2022-02-21
11100,세종특별자치시,646,6225,643,3,2022-02-21
49837,전라북도,2728,25939,2720,8,2022-02-21
43585,충청북도,2226,26389,2218,8,2022-02-21
50642,대전광역시,2907,16333,2907,0,2022-02-21
39125,강원도,2016,22893,2009,7,2022-02-21
30482,울산광역시,1941,18134,1941,0,2022-02-22
41182,강원도,2057,23554,2055,2,2022-02-22
92836,대구광역시,4158,59172,4158,0,2022-02-22
45772,충청북도,2187,28130,2181,6,2022-02-22
150084,인천광역시,7772,71128,7771,1,2022-02-22
11748,세종특별자치시,648,6667,648,0,2022-02-22
20244,제주특별자치도,1762,11681,1762,0,2022-02-23
56324,전라북도,4024,30386,4010,14,2022-02-23
161146,인천광역시,11063,76263,11060,3,2022-02-23
603209,서울특별시,41467,281356,41389,78,2022-02-23
709092,경기도,53532,230429,53524,8,2022-02-23
128676,부산광역시,12816,45415,12815,1,2022-02-23
44373,강원도,3192,23990,3192,0,2022-02-23
49247,충청북도,3475,29494,3469,6,2022-02-23
106290,대구광역시,7148,67317,7148,0,2022-02-24
640379,서울특별시,37172,284729,37106,66,2022-02-24
62073,대전광역시,4504,17326,4502,2,2022-02-24
81330,충청남도,4987,24932,4983,4,2022-02-24
13909,세종특별자치시,1082,7979,1082,0,2022-02-24
175009,인천광역시,13863,76264,13861,2,2022-02-24
53603,충청북도,4356,32474,4346,10,2022-02-24
46464,전라남도,3367,6933,3365,2,2022-02-24
21744,제주특별자치도,1505,13608,1505,0,2022-02-24
60240,전라북도,3916,32057,3912,4,2022-02-24
37159,울산광역시,3231,21631,3231,0,2022-02-24
105449,경상남도,9215,56726,9206,9,2022-02-24
153248,부산광역시,12736,46095,12733,3,2022-02-25
40691,울산광역시,3532,23862,3532,0,2022-02-25
112580,대구광역시,6290,71552,6290,0,2022-02-25
86514,충청남도,5184,26193,5175,9,2022-02-25
114348,경상남도,8899,65679,8892,7,2022-02-25
57571,충청북도,3968,35521,3962,6,2022-02-25
64457,전라북도,4217,33650,4208,9,2022-02-25
675993,서울특별시,35614,287973,35562,52,2022-02-25
64911,광주광역시,4604,13958,4598,6,2022-02-25
70744,대전광역시,4266,24926,4265,1,2022-02-26
856644,경기도,48150,230936,48147,3,2022-02-26
87847,경상북도,5305,31730,5301,4,2022-02-26
61363,충청북도,3792,36904,3778,14,2022-02-26
119575,대구광역시,6995,75684,6995,0,2022-02-26
15971,세종특별자치시,998,9676,996,2,2022-02-26
122993,경상남도,8645,65791,8638,7,2022-02-26
53434,전라남도,3437,6939,3433,4,2022-02-26
97761,충청남도,5963,26634,5950,13,2022-02-27
132240,경상남도,9247,65791,9242,5,2022-02-27
125731,대구광역시,6158,75684,6158,0,2022-02-27
47133,울산광역시,3315,25453,3315,0,2022-02-27
74067,광주광역시,4273,14056,4273,0,2022-02-27
72827,전라북도,4216,35458,4211,5,2022-02-27
16892,세종특별자치시,921,9676,920,1,2022-02-27
76896,전라북도,4070,35458,4066,4,2022-02-28
60885,강원도,3318,28233,3315,3,2022-02-28
776144,서울특별시,27973,292160,27911,62,2022-02-28
102845,충청남도,5084,26634,5078,6,2022-02-28
68506,충청북도,3053,36904,3046,7,2022-02-28
131556,대구광역시,5825,75684,5825,0,2022-02-28
940703,경기도,37258,230936,37258,0,2022-02-28
83040,광주광역시,4806,14258,4802,4,2022-03-01
52562,울산광역시,2944,33058,2944,0,2022-03-01
82149,대전광역시,3674,29157,3674,0,2022-03-01
107698,충청남도,4853,28956,4853,0,2022-03-01
72008,충청북도,3502,44678,3500,2,2022-03-01
64362,강원도,3477,30790,3477,0,2022-03-01
18602,세종특별자치시,876,12002,876,0,2022-03-01
63450,전라남도,3283,6943,3280,3,2022-03-01
87247,전라북도,6413,39182,6407,6,2022-03-02
87441,대전광역시,5292,29157,5292,0,2022-03-02
68446,전라남도,4996,6943,4992,4,2022-03-02
20014,세종특별자치시,1412,12002,1412,0,2022-03-02
114613,충청남도,6915,28956,6915,0,2022-03-02
57683,울산광역시,5121,33058,5121,0,2022-03-02
34176,제주특별자치도,2207,19567,2207,0,2022-03-02
73690,전라남도,5244,6951,5240,4,2022-03-03
258867,인천광역시,15964,93877,15964,0,2022-03-03
73948,강원도,4615,33478,4615,0,2022-03-03
37470,제주특별자치도,3294,21510,3294,0,2022-03-03
1177208,경기도,76726,232654,76722,4,2022-03-04
99070,전라북도,6539,50063,6536,3,2022-03-04
22613,세종특별자치시,1577,14834,1577,0,2022-03-04
89148,충청북도,6743,56474,6737,6,2022-03-04
79533,강원도,5585,33479,5584,1,2022-03-04
102071,광주광역시,6774,14414,6768,6,2022-03-04
129514,충청남도,8263,31103,8263,0,2022-03-04
85449,강원도,5916,34811,5915,1,2022-03-05
104159,대전광역시,5693,32428,5693,0,2022-03-05
86068,전라남도,5967,6951,5966,1,2022-03-05
294385,인천광역시,18838,93877,18838,0,2022-03-05
109478,광주광역시,7407,14494,7398,9,2022-03-05
44154,제주특별자치도,3285,27683,3285,0,2022-03-05
24071,세종특별자치시,1458,15950,1458,0,2022-03-05
204982,경상남도,15155,92938,15146,9,2022-03-05
106058,전라북도,6988,57751,6980,8,2022-03-05
309244,인천광역시,14859,93877,14854,5,2022-03-06
112909,전라북도,6851,57751,6840,11,2022-03-06
110347,대전광역시,6189,32428,6189,0,2022-03-06
1056548,서울특별시,49450,327273,49449,1,2022-03-06
180085,대구광역시,8896,111576,8896,0,2022-03-06
116135,광주광역시,6657,14494,6656,1,2022-03-06
91774,전라남도,5706,6951,5704,2,2022-03-06
102331,충청북도,6239,59971,6230,9,2022-03-06
144810,충청남도,7286,32214,7285,1,2022-03-06
25455,세종특별자치시,1384,15950,1384,0,2022-03-06
1314285,경기도,66837,232836,66833,4,2022-03-06
151585,충청남도,6775,32214,6774,1,2022-03-07
148653,경상북도,7514,47936,7509,5,2022-03-07
51075,제주특별자치도,3233,27683,3233,0,2022-03-07
97512,전라남도,5738,6951,5734,4,2022-03-07
1096106,서울특별시,39558,327273,39557,1,2022-03-07
96609,강원도,5451,34811,5451,0,2022-03-07
26618,세종특별자치시,1163,15950,1163,0,2022-03-07
81394,울산광역시,3913,42008,3913,0,2022-03-07
1133589,서울특별시,37484,344458,37483,1,2022-03-08
112969,충청북도,5736,67158,5733,3,2022-03-08
121715,대전광역시,5609,32464,5609,0,2022-03-08
129082,광주광역시,6473,14671,6461,12,2022-03-08
246887,경상남도,14031,119555,14028,3,2022-03-08
195460,대구광역시,7586,127967,7586,0,2022-03-08
382323,부산광역시,31153,68472,31152,1,2022-03-09
169407,충청남도,10825,35669,10825,0,2022-03-09
1514802,경기도,96684,233464,96681,3,2022-03-09
129692,대전광역시,7977,34668,7977,0,2022-03-09
168314,경상북도,12287,62715,12280,7,2022-03-09
110753,강원도,8686,37461,8686,0,2022-03-09
136500,광주광역시,7418,14727,7413,5,2022-03-09
1274661,서울특별시,66859,353601,66859,0,2022-03-10
219956,대구광역시,11601,136100,11601,0,2022-03-10
180278,경상북도,11964,62715,11960,4,2022-03-10
62910,제주특별자치도,4923,36235,4923,0,2022-03-10
32125,세종특별자치시,1944,19962,1944,0,2022-03-10
118925,강원도,8172,37461,8169,3,2022-03-10
1602946,경기도,88144,233464,88141,3,2022-03-10
180073,충청남도,10666,35669,10664,2,2022-03-10
190593,경상북도,10315,65808,10306,9,2022-03-11
395433,인천광역시,17458,103745,17457,1,2022-03-11
33965,세종특별자치시,1840,19962,1840,0,2022-03-11
106586,울산광역시,5261,57384,5261,0,2022-03-11
126407,강원도,7482,46484,7480,2,2022-03-11
67199,제주특별자치도,4289,39852,4289,0,2022-03-11
151646,광주광역시,8848,14727,8836,12,2022-03-11
144788,대전광역시,7212,34669,7212,0,2022-03-11
436820,부산광역시,22920,68472,22917,3,2022-03-11
153843,전라북도,8852,82010,8841,11,2022-03-11
67199,제주특별자치도,4289,36235,4289,0,2022-03-11
309731,경상남도,21428,135967,21422,6,2022-03-11
1675373,경기도,72427,233464,72420,7,2022-03-11
128930,전라남도,8987,6958,8984,3,2022-03-11
190593,경상북도,10315,62715,10306,9,2022-03-11
309731,경상남도,21428,135970,21422,6,2022-03-11
190871,충청남도,10798,39065,10798,0,2022-03-11
153303,대전광역시,8515,47485,8515,0,2022-03-12
139147,전라남도,10218,6959,10214,4,2022-03-12
164677,전라북도,10834,94870,10833,1,2022-03-12
243675,대구광역시,13414,159954,13414,0,2022-03-12
204514,충청남도,13643,50343,13642,1,2022-03-12
115686,울산광역시,9100,73212,9100,0,2022-03-12
1783312,경기도,107943,233939,107941,2,2022-03-12
215254,충청남도,10740,50343,10740,0,2022-03-13
78593,제주특별자치도,6203,47281,6203,0,2022-03-13
439407,인천광역시,20237,118912,20237,0,2022-03-13
161953,대전광역시,8650,47485,8650,0,2022-03-13
124853,울산광역시,9167,73212,9167,0,2022-03-13
230550,경상북도,12618,65806,12615,3,2022-03-14
187291,전라북도,11173,94870,11168,5,2022-03-14
383877,경상남도,23767,176950,23762,5,2022-03-14
170243,대전광역시,8290,47485,8290,0,2022-03-14
1536292,서울특별시,56807,374439,56807,0,2022-03-14
40941,세종특별자치시,2139,24464,2139,0,2022-03-14
268774,대구광역시,12406,159954,12406,0,2022-03-14
457646,인천광역시,18239,118912,18238,1,2022-03-14
154267,강원도,9045,50728,9044,1,2022-03-14
83420,제주특별자치도,4827,47281,4827,0,2022-03-14
1602354,서울특별시,66067,397219,66067,0,2022-03-15
171077,전라남도,11454,6962,11451,3,2022-03-15
138491,울산광역시,8302,87644,8302,0,2022-03-15
245090,경상북도,14540,129939,14536,4,2022-03-15
163973,강원도,9706,66401,9705,1,2022-03-15
148855,울산광역시,10364,94413,10362,2,2022-03-16
180388,전라남도,9314,6963,9309,5,2022-03-16
1683745,서울특별시,81395,412050,81395,0,2022-03-16
299879,대구광역시,16756,194654,16749,7,2022-03-16
595574,부산광역시,39438,111548,39436,2,2022-03-16
197731,광주광역시,10426,14979,10422,4,2022-03-16
95002,제주특별자치도,7682,58303,7680,2,2022-03-16
474251,경상남도,44539,255757,44536,3,2022-03-17
99146,제주특별자치도,4144,66937,4144,0,2022-03-17
189075,강원도,15449,70011,15449,0,2022-03-17
199846,대전광역시,12481,59136,12481,0,2022-03-17
214679,광주광역시,16948,14999,16948,0,2022-03-17
163623,울산광역시,14768,100070,14768,0,2022-03-17
1812116,서울특별시,128375,414063,128375,0,2022-03-17
1894113,서울특별시,81997,433203,81997,0,2022-03-18
53837,세종특별자치시,3116,34648,3116,0,2022-03-18
497988,경상남도,23737,275108,23731,6,2022-03-18
109951,제주특별자치도,6393,77750,6393,0,2022-03-19
586143,인천광역시,20838,152109,20838,0,2022-03-19
241692,광주광역시,11566,15057,11565,1,2022-03-19
221478,전라남도,10778,6970,10775,3,2022-03-19
314012,경상북도,14946,147896,14942,4,2022-03-19
2547159,경기도,101526,439111,101523,3,2022-03-19
233536,충청북도,11972,138636,11972,0,2022-03-19
708804,부산광역시,19543,282025,19543,0,2022-03-20
263055,전라북도,9685,164605,9684,1,2022-03-20
116179,제주특별자치도,6228,77750,6228,0,2022-03-20
605292,인천광역시,19149,152109,19149,0,2022-03-20
244808,충청북도,11272,138636,11272,0,2022-03-20
232376,전라남도,10898,6970,10898,0,2022-03-20
368813,대구광역시,13612,226678,13612,0,2022-03-20
374944,대구광역시,6131,226678,6131,0,2022-03-21
270954,전라북도,7899,164605,7898,1,2022-03-21
336778,경상북도,9776,147896,9768,8,2022-03-21
239233,전라남도,6857,6970,6857,0,2022-03-21
260184,광주광역시,8461,15057,8460,1,2022-03-21
634945,인천광역시,17569,167661,17568,1,2022-03-22
581709,경상남도,24703,296516,4,24707,2022-03-22
351205,경상북도,14429,148289,3,14432,2022-03-22
199065,울산광역시,8224,140460,0,8224,2022-03-22
267168,광주광역시,6986,15090,6985,1,2022-03-22
2788761,경기도,96256,439083,1,96257,2022-03-22
283511,전라북도,12584,164593,12584,0,2022-03-22
392298,대구광역시,17360,259941,0,17360,2022-03-22
199065,울산광역시,8224,140460,8224,0,2022-03-22
262002,충청북도,11829,164491,11828,1,2022-03-22
2148186,서울특별시,65033,480318,0,65033,2022-03-22
266306,대전광역시,14526,59221,14526,0,2022-03-23
210095,울산광역시,11031,151351,11031,0,2022-03-23
2925631,경기도,136912,439564,136912,0,2022-03-23
251564,강원도,14320,92224,14319,1,2022-03-23
413152,대구광역시,20866,281857,20866,0,2022-03-23
2249310,서울특별시,101133,504659,101133,0,2022-03-23
312335,전라북도,12916,207933,12914,2,2022-03-24
787179,부산광역시,18739,283093,18738,1,2022-03-24
390093,경상북도,18101,148280,18090,11,2022-03-24
2327080,서울특별시,77770,504657,77768,2,2022-03-24
277576,대전광역시,11270,59240,11270,0,2022-03-24
285834,대전광역시,8258,118864,0,8258,2022-03-25
302079,광주광역시,10259,15090,4,10263,2022-03-25
706346,인천광역시,21773,190339,0,21773,2022-03-25
225881,울산광역시,7433,167090,7433,0,2022-03-25
396078,충청남도,13817,276801,0,13817,2022-03-25
2393995,서울특별시,66941,516701,2,66943,2022-03-25
302079,광주광역시,10263,15090,10259,4,2022-03-25
803861,부산광역시,16705,283091,16705,0,2022-03-25
293285,전라남도,12670,6975,12670,0,2022-03-25
75297,세종특별자치시,3486,52514,0,3486,2022-03-25
405151,경상북도,15057,148280,4,15061,2022-03-25
138052,제주특별자치도,4789,105275,0,4789,2022-03-25
396078,충청남도,13817,276801,13817,0,2022-03-25
285834,대전광역시,8258,118864,8258,0,2022-03-25
306133,전라남도,12849,6976,12848,1,2022-03-26
420324,경상북도,15173,148280,15173,0,2022-03-26
2457986,서울특별시,64026,548170,64025,1,2022-03-26
3211522,경기도,90775,440080,90775,0,2022-03-26
142134,제주특별자치도,4082,115383,4082,0,2022-03-26
78304,세종특별자치시,3007,54882,3007,0,2022-03-26
311988,광주광역시,9909,15135,9907,2,2022-03-26
314386,충청북도,11616,210468,11614,2,2022-03-26
744699,인천광역시,21570,220559,21561,9,2022-03-27
348205,전라북도,10848,208050,10848,0,2022-03-27
2517137,서울특별시,59151,548170,59151,0,2022-03-27
325193,충청북도,10807,210468,10807,0,2022-03-27
318427,전라남도,12294,6976,12292,2,2022-03-27
3296904,경기도,85382,440080,85377,5,2022-03-27
305999,대전광역시,8963,118865,8963,0,2022-03-27
430974,충청남도,7956,291028,7956,0,2022-03-28
150144,제주특별자치도,3000,115383,3000,0,2022-03-28
756426,인천광역시,11727,220559,11726,1,2022-03-28
311280,대전광역시,5281,118865,5281,0,2022-03-28
3347478,경기도,50574,440080,50574,0,2022-03-28
355147,전라북도,6942,208050,6942,0,2022-03-28
2617360,서울특별시,66079,0,66078,1,2022-03-29
322386,대전광역시,11124,0,11124,0,2022-03-29
344094,충청북도,13075,0,13073,2,2022-03-29
370244,전라북도,15098,0,15092,6,2022-03-29
444965,충청남도,13997,0,13997,0,2022-03-29
336322,광주광역시,7920,0,7918,2,2022-03-29
85341,세종특별자치시,2476,0,2476,0,2022-03-29
340454,전라남도,13632,0,13632,0,2022-03-29
251519,울산광역시,7573,0,7573,0,2022-03-29
3436151,경기도,88702,0,88695,7,2022-03-29
191,전라남도,17462,0,17462,0,2022-03-30
323486,강원도,13113,0,13113,0,2022-03-30
3514,서울특별시,81824,0,81824,0,2022-03-30
689,경상남도,27038,0,27037,1,2022-03-30
88,제주특별자치도,5744,0,5744,0,2022-03-30
429,충청북도,15579,0,15579,0,2022-03-30
2699163,서울특별시,81824,0,81824,0,2022-03-30
912,대구광역시,17842,0,17842,0,2022-03-30
877689,부산광역시,16447,0,16447,0,2022-03-30
725,경상북도,20165,0,20161,4,2022-03-30
1001,인천광역시,23261,0,23261,0,2022-03-30
260612,울산광역시,9094,0,9094,0,2022-03-30
21,세종특별자치시,4248,0,4248,0,2022-03-30
511173,대구광역시,17842,0,17842,0,2022-03-30
371620,전라남도,13707,0,13706,1,2022-03-31
370985,충청북도,11322,0,11322,0,2022-03-31
478287,충청남도,14364,0,14364,0,2022-03-31
784309,경상남도,19315,0,19314,1,2022-03-31
359985,광주광역시,11362,0,11361,1,2022-03-31
890734,부산광역시,13053,0,13053,0,2022-03-31
3637764,경기도,84657,0,84657,0,2022-03-31
93479,세종특별자치시,3892,0,3892,0,2022-03-31
816626,인천광역시,18128,0,18128,0,2022-03-31
523883,대구광역시,12712,0,12712,0,2022-03-31
902585,부산광역시,11855,0,11855,0,2022-04-01
507130,경상북도,12974,0,12972,2,2022-04-01
343213,강원도,9064,0,9064,0,2022-04-01
414883,전라북도,9462,0,9462,0,2022-04-02
817499,경상남도,15942,0,15938,4,2022-04-02
359774,대전광역시,7989,0,7989,0,2022-04-02
503330,충청남도,11904,0,11903,1,2022-04-02
520198,경상북도,13070,0,13066,4,2022-04-02
2859633,서울특별시,48673,0,48673,0,2022-04-02
546536,대구광역시,11276,0,11276,0,2022-04-02
352269,강원도,9056,0,9053,3,2022-04-02
100537,세종특별자치시,1961,0,1961,0,2022-04-03
922389,부산광역시,9118,0,9117,1,2022-04-03
423397,전라북도,8514,0,8512,2,2022-04-03
175514,제주특별자치도,3581,0,3581,0,2022-04-03
514498,충청남도,11168,0,11168,0,2022-04-03
359765,강원도,7496,0,7496,0,2022-04-03
390095,광주광역시,5801,0,5801,0,2022-04-04
538220,경상북도,6270,0,6266,4,2022-04-04
371332,대전광역시,4586,0,4586,0,2022-04-04
285853,울산광역시,2481,0,2481,0,2022-04-04
102167,세종특별자치시,1630,0,1630,0,2022-04-04
177775,제주특별자치도,2261,0,2261,0,2022-04-04
403201,충청북도,3956,0,3956,0,2022-04-04
559685,대구광역시,3452,0,3452,0,2022-04-04
840006,경상남도,7385,0,7383,2,2022-04-04
926469,부산광역시,4080,0,4080,0,2022-04-04
520140,충청남도,5642,0,5642,0,2022-04-04
428485,전라북도,5088,0,5086,2,2022-04-04
549528,경상북도,11311,0,11310,1,2022-04-05
879987,인천광역시,15354,0,15354,0,2022-04-05
856190,경상남도,16187,0,16183,4,2022-04-05
438733,전라북도,10253,0,10246,7,2022-04-05
104410,세종특별자치시,2246,0,2246,0,2022-04-05
3953289,경기도,69364,0,69362,2,2022-04-05
412619,충청북도,9424,0,9424,0,2022-04-05
379111,대전광역시,7779,0,7779,0,2022-04-05
3026503,서울특별시,52430,0,52430,0,2022-04-06
564300,경상북도,14773,0,14769,4,2022-04-06
873370,경상남도,17182,0,17178,4,2022-04-06
556057,충청남도,10340,0,10340,0,2022-04-07
431107,충청북도,8222,0,8220,2,2022-04-07
906099,인천광역시,11271,0,11271,0,2022-04-07
575608,경상북도,11312,0,11308,4,2022-04-07
109212,세종특별자치시,2630,0,2630,0,2022-04-07
187860,제주특별자치도,3215,0,3215,0,2022-04-07
444275,전라남도,9908,0,9905,3,2022-04-07
457491,전라북도,8280,0,8271,9,2022-04-07
595072,대구광역시,9752,0,9752,0,2022-04-07
965134,부산광역시,7476,0,7476,0,2022-04-08
565566,충청남도,9509,0,9509,0,2022-04-08
438455,충청북도,7357,0,7357,0,2022-04-08
306481,울산광역시,4244,0,4244,0,2022-04-08
604294,대구광역시,9224,0,9224,0,2022-04-08
585993,경상북도,10385,0,10382,3,2022-04-08
310236,울산광역시,3756,0,3756,0,2022-04-09
4193411,경기도,48198,0,48198,0,2022-04-09
461383,전라남도,8437,0,8436,1,2022-04-09
404928,강원도,6620,0,6620,0,2022-04-09
574362,충청남도,8804,0,8804,0,2022-04-09
926416,인천광역시,9759,0,9759,0,2022-04-09
920057,경상남도,10180,0,10176,4,2022-04-10
414905,대전광역시,5403,0,5403,0,2022-04-10
410590,강원도,5662,0,5662,0,2022-04-10
113950,세종특별자치시,1353,0,1353,0,2022-04-10
469185,전라남도,7802,0,7802,0,2022-04-10
433990,광주광역시,5335,0,5332,3,2022-04-10
479658,전라북도,6728,0,6728,0,2022-04-10
582360,충청남도,7998,0,7998,0,2022-04-10
115052,세종특별자치시,1102,0,1102,0,2022-04-11
4261542,경기도,25775,0,25775,0,2022-04-11
939395,인천광역시,4385,0,4385,0,2022-04-11
980634,부산광역시,2507,0,2507,0,2022-04-11
622037,대구광역시,2992,0,2992,0,2022-04-11
609902,경상북도,5068,0,5062,6,2022-04-11
197718,제주특별자치도,1711,0,1711,0,2022-04-11
483420,전라북도,3762,0,3759,3,2022-04-11
413967,강원도,3377,0,3377,0,2022-04-11
4315720,경기도,54191,0,54191,0,2022-04-12
320038,울산광역시,4192,0,4192,0,2022-04-12
618782,경상북도,8882,0,8872,10,2022-04-12
420806,강원도,6840,0,6839,1,2022-04-12
428048,강원도,7243,0,7243,0,2022-04-13
605896,충청남도,9245,0,9245,0,2022-04-13
324087,울산광역시,4051,0,4051,0,2022-04-13
4367498,경기도,51796,0,51796,0,2022-04-13
491166,전라남도,8447,0,8446,1,2022-04-13
641753,대구광역시,8357,0,8357,0,2022-04-13
960706,인천광역시,9667,0,9667,0,2022-04-13
437074,대전광역시,5160,0,5160,0,2022-04-14
638886,경상북도,8042,0,8039,3,2022-04-14
3275574,서울특별시,24976,0,24976,0,2022-04-14
498075,전라남도,6912,0,6909,3,2022-04-14
648388,대구광역시,6635,0,6635,0,2022-04-14
653908,대구광역시,5522,0,5522,0,2022-04-15
975023,인천광역시,6690,0,6690,0,2022-04-15
4438056,경기도,32584,0,32584,0,2022-04-15
479696,충청북도,4637,0,4637,0,2022-04-15
121148,세종특별자치시,1195,0,1195,0,2022-04-15
207893,제주특별자치도,1619,0,1619,0,2022-04-16
1010486,부산광역시,3913,0,3913,0,2022-04-16
651751,경상북도,6158,0,6152,6,2022-04-16
658610,대구광역시,4703,0,4703,0,2022-04-16
980629,인천광역시,5606,0,5606,0,2022-04-16
3315132,서울특별시,18118,0,18118,0,2022-04-16
513157,전라남도,4396,0,4395,1,2022-04-17
487408,충청북도,3561,0,3558,3,2022-04-17
662820,대구광역시,4210,0,4210,0,2022-04-17
1013861,부산광역시,3375,0,3375,0,2022-04-17
4502575,경기도,13926,0,13926,0,2022-04-18
334937,울산광역시,932,0,932,0,2022-04-18
664446,대구광역시,1626,0,1626,0,2022-04-18
337321,울산광역시,2387,0,2387,0,2022-04-19
670946,대구광역시,6502,0,6502,0,2022-04-19
1020588,부산광역시,5384,0,5384,0,2022-04-19
994658,인천광역시,6668,0,6668,0,2022-04-19
1024337,부산광역시,3751,0,3751,0,2022-04-20
125478,세종특별자치시,1069,0,1069,0,2022-04-20
212825,제주특별자치도,1398,0,1398,0,2022-04-20
642509,충청남도,5244,0,5244,0,2022-04-20
461077,대전광역시,3005,0,3004,1,2022-04-21
680160,대구광역시,4203,0,4203,0,2022-04-21
214110,제주특별자치도,1285,0,1285,0,2022-04-21
678277,경상북도,5661,0,5660,1,2022-04-21
529274,전라남도,3975,0,3974,1,2022-04-21
539271,전라북도,3349,0,3347,2,2022-04-22
1031003,부산광역시,3130,0,3130,0,2022-04-22
462475,강원도,3169,0,3169,0,2022-04-22
343611,울산광역시,1852,0,1852,0,2022-04-22
1002777,경상남도,4625,0,4625,0,2022-04-22
1012531,인천광역시,3674,0,3674,0,2022-04-23
542568,전라북도,3297,0,3297,0,2022-04-23
688156,대구광역시,3966,0,3966,0,2022-04-23
127469,세종특별자치시,626,0,626,0,2022-04-23
506793,충청북도,2732,0,2728,4,2022-04-23
1007087,경상남도,4310,0,4305,5,2022-04-23
468891,대전광역시,2297,0,2292,5,2022-04-24
539829,전라남도,3171,0,3171,0,2022-04-24
490293,광주광역시,2373,0,2371,2,2022-04-24
3428475,서울특별시,10377,0,10375,2,2022-04-24
545543,전라북도,2975,0,2974,1,2022-04-24
128271,세종특별자치시,416,0,416,0,2022-04-25
470315,대전광역시,1424,0,1424,0,2022-04-25
1017506,인천광역시,1656,0,1654,2,2022-04-25
692977,대구광역시,1422,0,1422,0,2022-04-25
218048,제주특별자치도,734,0,734,0,2022-04-25
541617,전라남도,1788,0,1787,1,2022-04-25
4646551,경기도,9058,0,9058,0,2022-04-25
1037874,부산광역시,1072,0,1072,0,2022-04-25
3446789,서울특별시,13560,0,13559,1,2022-04-26
662877,충청남도,3738,0,3738,0,2022-04-26
4665892,경기도,19363,0,19362,1,2022-04-26
1021782,인천광역시,4282,0,4282,0,2022-04-26
472793,대전광역시,2478,0,2477,1,2022-04-26
218794,제주특별자치도,746,0,746,0,2022-04-26
513381,충청북도,2768,0,2767,1,2022-04-26
471830,강원도,3015,0,3014,1,2022-04-26
349482,울산광역시,1753,0,1753,0,2022-04-26
698372,경상북도,4348,0,4347,1,2022-04-26
4684310,경기도,18424,0,18415,9,2022-04-27
351254,울산광역시,1772,0,1772,0,2022-04-27
516306,충청북도,2926,0,2924,2,2022-04-27
1044893,부산광역시,3027,0,3027,0,2022-04-27
129525,세종특별자치시,589,0,589,0,2022-04-27
475513,대전광역시,2720,0,2719,1,2022-04-27
476981,강원도,2196,0,2196,0,2022-04-28
220876,제주특별자치도,846,0,846,0,2022-04-28
518330,충청북도,2025,0,2022,3,2022-04-28
557072,전라북도,2654,0,2654,0,2022-04-28
4697965,경기도,13657,0,13657,0,2022-04-28
1028249,인천광역시,2845,0,2845,0,2022-04-28
669240,충청남도,2672,0,2672,0,2022-04-28
1026487,경상남도,3728,0,3726,2,2022-04-28
479245,대전광역시,1733,0,1730,3,2022-04-29
706817,대구광역시,2507,0,2507,0,2022-04-29
671565,충청남도,2325,0,2325,0,2022-04-29
1049589,부산광역시,2254,0,2254,0,2022-04-29
353783,울산광역시,1141,0,1141,0,2022-04-29
559483,전라북도,2412,0,2411,1,2022-04-29
480465,강원도,1644,0,1644,0,2022-04-30
1051615,부산광역시,2031,0,2031,0,2022-04-30
521774,충청북도,1471,0,1471,0,2022-04-30
561480,전라북도,1998,0,1998,0,2022-04-30
673506,충청남도,1943,0,1943,0,2022-04-30
131035,세종특별자치시,360,0,360,0,2022-05-01
1034222,인천광역시,1760,0,1759,1,2022-05-01
1053250,부산광역시,1635,0,1635,0,2022-05-01
222986,제주특별자치도,577,0,577,0,2022-05-01
558446,전라남도,1962,0,1961,1,2022-05-01
564148,전라북도,926,0,919,7,2022-05-02
1035133,인천광역시,911,0,908,3,2022-05-02
559441,전라남도,995,0,995,0,2022-05-02
3489696,서울특별시,2653,0,2653,0,2022-05-02
482709,대전광역시,675,0,674,1,2022-05-02
223809,제주특별자치도,391,0,391,0,2022-05-03
678613,충청남도,2411,0,2411,0,2022-05-03
357433,울산광역시,1195,0,1195,0,2022-05-03
484398,강원도,1781,0,1780,1,2022-05-03
566088,전라북도,1941,0,1939,2,2022-05-03
564337,전라남도,2348,0,2346,2,2022-05-04
224538,제주특별자치도,729,0,728,1,2022-05-04
680874,충청남도,2261,0,2261,0,2022-05-04
486257,강원도,1861,0,1860,1,2022-05-04
724977,경상북도,3794,0,3794,0,2022-05-04
1058982,부산광역시,2171,0,2171,0,2022-05-04
4757630,경기도,11671,0,11670,1,2022-05-04
1042825,경상남도,3094,0,3092,2,2022-05-04
1039906,인천광역시,2167,0,2166,1,2022-05-04
568160,전라북도,2074,0,2069,5,2022-05-04
529217,충청북도,1507,0,1505,2,2022-05-05
4767866,경기도,10242,0,10242,0,2022-05-05
359595,울산광역시,1043,0,1043,0,2022-05-05
682797,충청남도,1923,0,1923,0,2022-05-05
727913,경상북도,2938,0,2938,0,2022-05-05
1045432,경상남도,2607,0,2606,1,2022-05-05
509758,광주광역시,1450,0,1449,1,2022-05-05
1061894,부산광역시,866,0,866,0,2022-05-06
721235,대구광역시,1312,0,1312,0,2022-05-06
1043084,인천광역시,1164,0,1153,11,2022-05-06
567561,전라남도,1298,0,1298,0,2022-05-06
4774034,경기도,6168,0,6168,0,2022-05-06
225685,제주특별자치도,571,0,571,0,2022-05-06
3516017,서울특별시,3596,0,3596,0,2022-05-06
3522657,서울특별시,6641,0,6639,2,2022-05-07
490328,강원도,1487,0,1486,1,2022-05-07
4783473,경기도,9444,0,9444,0,2022-05-07
723548,대구광역시,2314,0,2314,0,2022-05-07
491759,강원도,1431,0,1431,0,2022-05-08
1065976,부산광역시,1805,0,1805,0,2022-05-08
735727,경상북도,2964,0,2961,3,2022-05-08
4792026,경기도,8553,0,8553,0,2022-05-08
492567,강원도,808,0,808,0,2022-05-09
492160,대전광역시,778,0,778,0,2022-05-09
726941,대구광역시,972,0,972,0,2022-05-09
533996,충청북도,701,0,699,2,2022-05-09
3531351,서울특별시,2715,0,2715,0,2022-05-09
1053759,경상남도,1375,0,1372,3,2022-05-09
737282,경상북도,1555,0,1554,1,2022-05-09
4797513,경기도,5487,0,5485,2,2022-05-09
362766,울산광역시,474,0,474,0,2022-05-09
688416,충청남도,906,0,906,0,2022-05-09
494394,강원도,1828,0,1828,0,2022-05-10
740115,경상북도,2835,0,2833,2,2022-05-10
364086,울산광역시,1321,0,1321,0,2022-05-10
515999,광주광역시,1523,0,1523,0,2022-05-10
4808841,경기도,11334,0,11334,0,2022-05-10
732404,대구광역시,2223,0,2223,0,2022-05-11
1052463,인천광역시,2175,0,2162,13,2022-05-11
579714,전라북도,1961,0,1961,0,2022-05-11
4827730,경기도,8392,0,8392,0,2022-05-12
734292,대구광역시,1888,0,1888,0,2022-05-12
3551375,서울특별시,5695,0,5695,0,2022-05-12
694365,충청남도,1605,0,1605,0,2022-05-12
746078,경상북도,2629,0,2627,2,2022-05-12
538858,충청북도,1400,0,1398,2,2022-05-12
3556545,서울특별시,5178,0,5178,0,2022-05-13
582580,전라북도,1402,0,1400,2,2022-05-13
367124,울산광역시,816,0,816,0,2022-05-13
736086,대구광역시,1796,0,1796,0,2022-05-13
520067,광주광역시,1099,0,1097,2,2022-05-13
1064209,경상남도,2082,0,2081,1,2022-05-13
497479,대전광역시,1058,0,1055,3,2022-05-13
579331,전라남도,1394,0,1394,0,2022-05-13
4842445,경기도,6982,0,6980,2,2022-05-14
750469,경상북도,2107,0,2104,3,2022-05-14
1076333,부산광역시,1540,0,1540,0,2022-05-14
367904,울산광역시,781,0,781,0,2022-05-14
499699,강원도,1155,0,1155,0,2022-05-14
580565,전라남도,1234,0,1234,0,2022-05-14
1066168,경상남도,1959,0,1957,2,2022-05-14
135349,세종특별자치시,228,0,228,0,2022-05-15
4848245,경기도,5800,0,5799,1,2022-05-15
499286,대전광역시,923,0,923,0,2022-05-15
368671,울산광역시,767,0,767,0,2022-05-15
1058231,인천광역시,1158,0,1150,8,2022-05-15
582195,전라남도,505,0,503,2,2022-05-16
739467,대구광역시,564,0,564,0,2022-05-16
1077834,부산광역시,474,0,474,0,2022-05-16
501249,강원도,587,0,584,3,2022-05-16
698924,충청남도,638,0,638,0,2022-05-16
368991,울산광역시,320,0,320,0,2022-05-16
542569,충청북도,453,0,452,1,2022-05-16
1079744,부산광역시,1914,0,1914,0,2022-05-17
543757,충청북도,1189,0,1186,3,2022-05-17
1060562,인천광역시,1725,0,1715,10,2022-05-17
135802,세종특별자치시,294,0,294,0,2022-05-17
586871,전라북도,1371,0,1369,2,2022-05-17
583449,전라남도,1255,0,1255,0,2022-05-17
741562,대구광역시,2095,0,2095,0,2022-05-17
588120,전라북도,1250,0,1246,4,2022-05-18
701936,충청남도,1469,0,1468,1,2022-05-18
370681,울산광역시,856,0,856,0,2022-05-18
230921,제주특별자치도,442,0,442,0,2022-05-18
1061957,인천광역시,1395,0,1387,8,2022-05-18
743090,대구광역시,1528,0,1527,1,2022-05-18
136368,세종특별자치시,269,0,269,0,2022-05-19
703400,충청남도,1471,0,1471,0,2022-05-19
524990,광주광역시,818,0,817,1,2022-05-19
1063293,인천광역시,1337,0,1334,3,2022-05-19
744550,대구광역시,1462,0,1461,1,2022-05-19
1082480,부산광역시,1261,0,1261,0,2022-05-19
502801,대전광역시,950,0,950,0,2022-05-19
546791,충청북도,909,0,905,4,2022-05-20
525811,광주광역시,821,0,821,0,2022-05-20
704585,충청남도,1185,0,1185,0,2022-05-20
136806,세종특별자치시,209,0,209,0,2022-05-21
507450,강원도,1103,0,1103,0,2022-05-21
1084656,부산광역시,1094,0,1094,0,2022-05-21
547584,충청북도,795,0,794,1,2022-05-21
705567,충청남도,989,0,989,0,2022-05-21
4887196,경기도,5693,0,5693,0,2022-05-21
526562,광주광역시,751,0,749,2,2022-05-21
1077670,경상남도,1515,0,1513,2,2022-05-21
232053,제주특별자치도,380,0,380,0,2022-05-21
762885,경상북도,1663,0,1661,2,2022-05-21
372720,울산광역시,626,0,626,0,2022-05-21
505084,대전광역시,695,0,693,2,2022-05-22
373371,울산광역시,651,0,651,0,2022-05-22
508278,강원도,828,0,826,2,2022-05-22
232333,제주특별자치도,280,0,280,0,2022-05-22
527180,광주광역시,618,0,617,1,2022-05-22
527522,광주광역시,342,0,342,0,2022-05-23
373581,울산광역시,210,0,210,0,2022-05-23
137099,세종특별자치시,109,0,109,0,2022-05-23
505470,대전광역시,386,0,386,0,2022-05-23
548585,충청북도,330,0,329,1,2022-05-23
1087409,부산광역시,1528,0,1527,1,2022-05-24
137373,세종특별자치시,275,0,275,0,2022-05-24
4900150,경기도,6031,0,6031,0,2022-05-24
507222,대전광역시,844,0,843,1,2022-05-25
137627,세종특별자치시,254,0,254,0,2022-05-25
1088448,부산광역시,1039,0,1039,0,2022-05-25
528930,광주광역시,814,0,809,5,2022-05-25
591413,전라남도,674,0,674,0,2022-05-26
3604920,서울특별시,2788,0,2787,1,2022-05-26
507850,대전광역시,628,0,628,0,2022-05-26
4909754,경기도,4351,0,4350,1,2022-05-26
1069501,인천광역시,757,0,743,14,2022-05-26
710593,충청남도,776,0,776,0,2022-05-27
771791,경상북도,1390,0,1388,2,2022-05-27
137940,세종특별자치시,152,0,152,0,2022-05-27
1090826,부산광역시,682,0,682,0,2022-05-28
596540,전라북도,584,0,582,2,2022-05-28
772855,경상북도,1065,0,1063,2,2022-05-28
4916570,경기도,3255,0,3254,1,2022-05-28
552013,충청북도,488,0,485,3,2022-05-28
1086105,경상남도,937,0,931,6,2022-05-28
138054,세종특별자치시,114,0,114,0,2022-05-28
711217,충청남도,624,0,624,0,2022-05-28
234306,제주특별자치도,280,0,280,0,2022-05-28
1091364,부산광역시,538,0,538,0,2022-05-29
509315,대전광역시,446,0,446,0,2022-05-29
4919409,경기도,2839,0,2839,0,2022-05-29
552470,충청북도,457,0,456,1,2022-05-29
530903,광주광역시,420,0,414,6,2022-05-29
1086922,경상남도,817,0,815,2,2022-05-29
552684,충청북도,214,0,212,2,2022-05-30
1071436,인천광역시,276,0,255,21,2022-05-30
4920879,경기도,1470,0,1468,2,2022-05-30
513821,강원도,296,0,296,0,2022-05-30
756711,대구광역시,301,0,300,1,2022-05-30
597288,전라북도,228,0,225,3,2022-05-30
4924651,경기도,3776,0,3775,1,2022-05-31
234923,제주특별자치도,236,0,236,0,2022-05-31
531536,광주광역시,431,0,428,3,2022-05-31
1072110,인천광역시,676,0,660,16,2022-05-31
510037,대전광역시,548,0,548,0,2022-05-31
514517,강원도,696,0,695,1,2022-05-31
377545,울산광역시,495,0,494,1,2022-05-31
713464,충청남도,663,0,663,0,2022-06-01
1072644,인천광역시,537,0,520,17,2022-06-01
758960,대구광역시,942,0,942,0,2022-06-01
138615,세종특별자치시,99,0,99,0,2022-06-02
1093546,부산광역시,402,0,401,1,2022-06-02
594665,전라남도,325,0,325,0,2022-06-02
759648,대구광역시,688,0,688,0,2022-06-02
554246,충청북도,336,0,332,4,2022-06-02
235546,제주특별자치도,142,0,142,0,2022-06-03
3623883,서울특별시,2442,0,2439,3,2022-06-03
760563,대구광역시,915,0,915,0,2022-06-03
378689,울산광역시,362,0,362,0,2022-06-03
595092,전라남도,429,0,429,0,2022-06-03
555058,충청북도,398,0,396,2,2022-06-04
511531,대전광역시,321,0,321,0,2022-06-04
138830,세종특별자치시,104,0,104,0,2022-06-04
4935892,경기도,2746,0,2745,1,2022-06-04
1095245,부산광역시,472,0,472,0,2022-06-05
1074417,인천광역시,415,0,398,17,2022-06-05
517231,강원도,384,0,380,4,2022-06-05
600159,전라북도,193,0,192,1,2022-06-06
3628593,서울특별시,738,0,738,0,2022-06-06
4939422,경기도,1340,0,1340,0,2022-06-06
512039,대전광역시,195,0,193,2,2022-06-06
715847,충청남도,298,0,297,1,2022-06-07
762533,대구광역시,339,0,338,1,2022-06-07
379618,울산광역시,187,0,187,0,2022-06-07
512236,대전광역시,197,0,197,0,2022-06-07
533472,광주광역시,142,0,139,3,2022-06-07
555808,충청북도,245,0,243,2,2022-06-07
596646,전라남도,446,0,441,5,2022-06-08
236353,제주특별자치도,174,0,171,3,2022-06-08
4943924,경기도,3075,0,3073,2,2022-06-08
1075395,인천광역시,533,0,517,16,2022-06-08
533825,광주광역시,353,0,350,3,2022-06-08
556208,충청북도,401,0,394,7,2022-06-08
716305,충청남도,458,0,457,1,2022-06-08
1075806,인천광역시,411,0,399,12,2022-06-09
1094209,경상남도,697,0,695,2,2022-06-09
3634172,서울특별시,2009,0,2008,1,2022-06-09
139294,세종특별자치시,118,0,118,0,2022-06-09
236714,제주특별자치도,162,0,157,5,2022-06-10
597490,전라남도,350,0,350,0,2022-06-10
4948774,경기도,2123,0,2120,3,2022-06-10
381010,울산광역시,295,0,295,0,2022-06-11
513517,대전광역시,250,0,250,0,2022-06-11
557267,충청북도,304,0,294,10,2022-06-11
1095230,경상남도,471,0,467,4,2022-06-11
3637088,서울특별시,1382,0,1380,2,2022-06-11
1098165,부산광역시,446,0,446,0,2022-06-11
598087,전라남도,279,0,279,0,2022-06-12
784540,경상북도,573,0,565,8,2022-06-12
520091,강원도,360,0,357,3,2022-06-12
1098582,부산광역시,417,0,417,0,2022-06-12
139565,세종특별자치시,82,0,82,0,2022-06-12
3638248,서울특별시,1160,0,1159,1,2022-06-12
602105,전라북도,272,0,264,8,2022-06-12
4952525,경기도,1690,0,1684,6,2022-06-12
534873,광주광역시,192,0,188,4,2022-06-12
717883,충청남도,285,0,282,3,2022-06-12
1095670,경상남도,440,0,436,4,2022-06-12
765691,대구광역시,396,0,391,5,2022-06-12
534981,광주광역시,108,0,100,8,2022-06-13
3638911,서울특별시,663,0,659,4,2022-06-13
381417,울산광역시,110,0,110,0,2022-06-13
602511,전라북도,297,0,295,2,2022-06-14
237178,제주특별자치도,112,0,107,5,2022-06-14
1077530,인천광역시,595,0,590,5,2022-06-14
381723,울산광역시,306,0,306,0,2022-06-14
786075,경상북도,686,0,678,8,2022-06-15
4958176,경기도,2288,0,2282,6,2022-06-15
558248,충청북도,323,0,316,7,2022-06-15
602781,전라북도,270,0,266,4,2022-06-15
3643911,서울특별시,1549,0,1547,2,2022-06-16
514636,대전광역시,195,0,194,1,2022-06-16
599031,전라남도,239,0,235,4,2022-06-16
767538,대구광역시,466,0,461,5,2022-06-16
382324,울산광역시,284,0,282,2,2022-06-16
1097982,경상남도,522,0,518,4,2022-06-17
535741,광주광역시,162,0,159,3,2022-06-17
514813,대전광역시,177,0,175,2,2022-06-17
599264,전라남도,233,0,232,1,2022-06-17
558681,충청북도,188,0,181,7,2022-06-17
1101322,부산광역시,421,0,421,0,2022-06-18
558883,충청북도,202,0,201,1,2022-06-18
1098462,경상남도,480,0,476,4,2022-06-18
383068,울산광역시,243,0,243,0,2022-06-19
522323,강원도,250,0,249,1,2022-06-19
139961,세종특별자치시,52,0,47,5,2022-06-19
603558,전라북도,184,0,179,5,2022-06-19
599684,전라남도,212,0,209,3,2022-06-19
140005,세종특별자치시,44,0,40,4,2022-06-20
599795,전라남도,111,0,110,1,2022-06-20
720015,충청남도,134,0,127,7,2022-06-20
1099030,경상남도,194,0,184,10,2022-06-20
788144,경상북도,228,0,222,6,2022-06-20
536126,광주광역시,116,0,107,9,2022-06-20
1079315,인천광역시,222,0,188,34,2022-06-20
1101815,부산광역시,149,0,148,1,2022-06-20
1099607,경상남도,577,0,573,4,2022-06-21
600071,전라남도,276,0,276,0,2022-06-21
769551,대구광역시,587,0,584,3,2022-06-21
720703,충청남도,365,0,365,0,2022-06-22
1102899,부산광역시,552,0,551,1,2022-06-22
4970653,경기도,2281,0,2281,0,2022-06-22
559618,충청북도,223,0,215,8,2022-06-22
238126,제주특별자치도,163,0,152,11,2022-06-22
515547,대전광역시,204,0,204,0,2022-06-22
536489,광주광역시,183,0,180,3,2022-06-22
1080566,인천광역시,372,0,346,26,2022-06-23
789423,경상북도,388,0,379,9,2022-06-23
604329,전라북도,182,0,178,4,2022-06-23
3653647,서울특별시,1580,0,1577,3,2022-06-23
560008,충청북도,178,0,176,2,2022-06-24
1103738,부산광역시,396,0,396,0,2022-06-24
600746,전라남도,182,0,182,0,2022-06-24
770754,대구광역시,384,0,379,5,2022-06-24
384249,울산광역시,179,0,176,3,2022-06-24
789828,경상북도,405,0,393,12,2022-06-24
790173,경상북도,346,0,340,6,2022-06-25
604712,전라북도,179,0,175,4,2022-06-25
523963,강원도,249,0,246,3,2022-06-25
1101417,경상남도,405,0,396,9,2022-06-25
238442,제주특별자치도,85,0,77,8,2022-06-25
384669,울산광역시,229,0,227,2,2022-06-26
604983,전라북도,92,0,90,2,2022-06-27
790689,경상북도,200,0,190,10,2022-06-27
524273,강원도,131,0,128,3,2022-06-27
721828,충청남도,142,0,141,1,2022-06-27
516544,대전광역시,221,0,221,0,2022-06-28
791029,경상북도,340,0,334,6,2022-06-28
537236,광주광역시,129,0,128,1,2022-06-28
140467,세종특별자치시,52,0,52,0,2022-06-28
385024,울산광역시,269,0,268,1,2022-06-28
722149,충청남도,321,0,319,2,2022-06-28
560663,충청북도,221,0,217,4,2022-06-28
601869,전라남도,268,0,263,5,2022-06-29
722529,충청남도,380,0,377,3,2022-06-29
1105943,부산광역시,595,0,595,0,2022-06-29
385365,울산광역시,341,0,336,5,2022-06-29
1083459,인천광역시,506,0,474,32,2022-06-30
561112,충청북도,218,0,208,10,2022-06-30
606083,전라북도,253,0,249,4,2022-07-01
773119,대구광역시,423,0,414,9,2022-07-01
239250,제주특별자치도,184,0,167,17,2022-07-01
517252,대전광역시,209,0,208,1,2022-07-01
3668271,서울특별시,2340,0,2333,7,2022-07-01
3671044,서울특별시,2778,0,2768,10,2022-07-02
1084459,인천광역시,525,0,472,53,2022-07-02
793041,경상북도,503,0,490,13,2022-07-02
793578,경상북도,537,0,521,16,2022-07-03
1085025,인천광역시,566,0,516,50,2022-07-03
606625,전라북도,268,0,257,11,2022-07-03
239847,제주특별자치도,174,0,171,3,2022-07-04
1105795,경상남도,332,0,316,16,2022-07-04
606751,전라북도,126,0,119,7,2022-07-04
724180,충청남도,240,0,240,0,2022-07-04
386681,울산광역시,148,0,148,0,2022-07-04
4996307,경기도,1895,0,1890,5,2022-07-04
793891,경상북도,313,0,299,14,2022-07-04
538587,광주광역시,280,0,272,8,2022-07-05
1109727,부산광역시,1169,0,1169,0,2022-07-05
3679421,서울특별시,4779,0,4777,2,2022-07-05
1106868,경상남도,1074,0,1065,9,2022-07-05
603368,전라남도,385,0,380,5,2022-07-05
1107933,경상남도,1066,0,1049,17,2022-07-06
1087425,인천광역시,1071,0,1022,49,2022-07-06
795489,경상북도,942,0,925,17,2022-07-06
538924,광주광역시,337,0,326,11,2022-07-06
5006368,경기도,5174,0,5159,15,2022-07-06
519356,대전광역시,488,0,485,3,2022-07-07
1108904,경상남도,971,0,959,12,2022-07-07
3688769,서울특별시,4580,0,4574,6,2022-07-07
604238,전라남도,411,0,406,5,2022-07-07
5016754,경기도,5410,0,5395,15,2022-07-08
241320,제주특별자치도,394,0,383,11,2022-07-08
1109943,경상남도,1039,0,1018,21,2022-07-08
776642,대구광역시,627,0,617,10,2022-07-08
797045,경상북도,759,0,750,9,2022-07-08
528997,강원도,546,0,534,12,2022-07-09
797790,경상북도,745,0,734,11,2022-07-09
241686,제주특별자치도,366,0,357,9,2022-07-09
1090448,인천광역시,1067,0,1011,56,2022-07-09
520417,대전광역시,504,0,497,7,2022-07-09
1114561,부산광역시,1280,0,1279,1,2022-07-09
389860,울산광역시,646,0,643,3,2022-07-10
777842,대구광역시,488,0,477,11,2022-07-10
141796,세종특별자치시,196,0,190,6,2022-07-10
1116484,부산광역시,626,0,626,0,2022-07-11
1092017,인천광역시,638,0,582,56,2022-07-11
540586,광주광역시,267,0,256,11,2022-07-11
566278,충청북도,977,0,967,10,2022-07-12
522324,대전광역시,914,0,908,6,2022-07-12
611021,전라북도,991,0,981,10,2022-07-12
3715539,서울특별시,9412,0,9403,9,2022-07-12
606523,전라남도,754,0,747,7,2022-07-12
392321,울산광역시,1129,0,1119,10,2022-07-13
1117028,경상남도,2166,0,2143,23,2022-07-13
731780,충청남도,1598,0,1573,25,2022-07-13
5053273,경기도,11175,0,11118,57,2022-07-13
244897,제주특별자치도,854,0,842,12,2022-07-14
733296,충청남도,1516,0,1498,18,2022-07-14
568390,충청북도,1044,0,1032,12,2022-07-14
569431,충청북도,1041,0,1030,11,2022-07-15
143116,세종특별자치시,259,0,258,1,2022-07-15
3743496,서울특별시,8951,0,8942,9,2022-07-15
3752951,서울특별시,9457,0,9449,8,2022-07-16
806850,경상북도,1622,0,1603,19,2022-07-16
5085860,경기도,11448,0,11417,31,2022-07-16
534946,강원도,1111,0,1103,8,2022-07-16
571991,충청북도,1279,0,1261,18,2022-07-17
5096903,경기도,11043,0,11025,18,2022-07-17
397617,울산광역시,609,0,608,1,2022-07-18
248606,제주특별자치도,832,0,819,13,2022-07-18
1126868,경상남도,1164,0,1138,26,2022-07-18
738836,충청남도,982,0,969,13,2022-07-18
617357,전라북도,683,0,672,11,2022-07-18
546007,광주광역시,580,0,557,23,2022-07-18
1106259,인천광역시,1944,0,1857,87,2022-07-18
1110491,인천광역시,4238,0,4124,114,2022-07-19
741592,충청남도,2756,0,2729,27,2022-07-19
5125263,경기도,20100,0,20083,17,2022-07-19
613080,전라남도,1658,0,1649,9,2022-07-19
547375,광주광역시,1368,0,1348,20,2022-07-19
811818,경상북도,2218,0,2203,15,2022-07-19
144564,세종특별자치시,559,0,551,8,2022-07-19
614682,전라남도,1604,0,1593,11,2022-07-20
814967,경상북도,3149,0,3112,37,2022-07-20
540995,강원도,2204,0,2186,18,2022-07-20
621648,전라북도,2200,0,2179,21,2022-07-20
1114902,인천광역시,4412,0,4324,88,2022-07-20
549098,광주광역시,1723,0,1694,29,2022-07-20
794914,대구광역시,2405,0,2391,14,2022-07-21
403810,울산광역시,2020,0,2014,6,2022-07-21
253367,제주특별자치도,1601,0,1572,29,2022-07-21
623833,전라북도,2185,0,2166,19,2022-07-21
817793,경상북도,2829,0,2809,20,2022-07-21
1150202,부산광역시,3797,0,3793,4,2022-07-22
626085,전라북도,2257,0,2239,18,2022-07-22
580964,충청북도,2169,0,2151,18,2022-07-22
1141724,경상남도,3564,0,3542,22,2022-07-22
628261,전라북도,2176,0,2163,13,2022-07-23
407545,울산광역시,1865,0,1863,2,2022-07-23
1126260,인천광역시,3759,0,3710,49,2022-07-23
1154143,부산광역시,3942,0,3937,5,2022-07-23
256424,제주특별자치도,1589,0,1580,9,2022-07-23
1145502,경상남도,3778,0,3763,15,2022-07-23
549053,강원도,1895,0,1882,13,2022-07-24
258102,제주특별자치도,1678,0,1665,13,2022-07-24
585361,충청북도,2257,0,2238,19,2022-07-24
1157694,부산광역시,3551,0,3548,3,2022-07-24
755057,충청남도,2645,0,2620,25,2022-07-24
622519,전라남도,992,0,987,5,2022-07-25
410231,울산광역시,702,0,702,0,2022-07-25
550119,강원도,1066,0,1058,8,2022-07-25
828393,경상북도,1771,0,1739,32,2022-07-25
1156429,경상남도,5463,0,5437,26,2022-07-26
3891336,서울특별시,23107,0,23106,1,2022-07-26
634745,전라북도,2915,0,2908,7,2022-07-26
836714,경상북도,4968,0,4921,47,2022-07-27
5285963,경기도,27214,0,27154,60,2022-07-27
415292,울산광역시,2674,0,2657,17,2022-07-27
1170733,부산광역시,5289,0,5287,2,2022-07-27
546947,대전광역시,2845,0,2822,23,2022-07-27
630105,전라남도,2418,0,2410,8,2022-07-28
564428,광주광역시,2469,0,2443,26,2022-07-28
566809,광주광역시,2381,0,2369,12,2022-07-29
5333741,경기도,23565,0,23516,49,2022-07-29
1155639,인천광역시,4117,0,4042,75,2022-07-30
1175236,경상남도,4448,0,4423,25,2022-07-30
646758,전라북도,2926,0,2907,19,2022-07-30
151020,세종특별자치시,623,0,615,8,2022-07-30
3977775,서울특별시,14149,0,14149,0,2022-07-31
778596,충청남도,3250,0,3238,12,2022-07-31
5387764,경기도,13007,0,12983,24,2022-08-01
824310,대구광역시,1948,0,1933,15,2022-08-01
270878,제주특별자치도,1013,0,1005,8,2022-08-01
568058,강원도,1451,0,1441,10,2022-08-01
638424,전라남도,1448,0,1446,2,2022-08-01
1181465,경상남도,2256,0,2226,30,2022-08-01
425091,울산광역시,1096,0,1092,4,2022-08-01
152972,세종특별자치시,1010,0,1004,6,2022-08-02
272381,제주특별자치도,1503,0,1487,16,2022-08-02
1187466,경상남도,6002,0,5978,24,2022-08-02
1167765,인천광역시,5747,0,5624,123,2022-08-02
575406,광주광역시,2649,0,2595,54,2022-08-02
641555,전라남도,3131,0,3101,30,2022-08-02
859550,경상북도,4404,0,4362,42,2022-08-02
1197451,부산광역시,7013,0,7009,4,2022-08-02
562623,대전광역시,4166,0,4119,47,2022-08-02
865735,경상북도,6185,0,6146,39,2022-08-03
1193844,경상남도,6380,0,6352,28,2022-08-03
578959,광주광역시,3553,0,3489,64,2022-08-03
612390,충청북도,3954,0,3916,38,2022-08-03
154837,세종특별자치시,918,0,916,2,2022-08-04
5477347,경기도,27827,0,27799,28,2022-08-04
648343,전라남도,3159,0,3143,16,2022-08-04
794624,충청남도,4362,0,4341,21,2022-08-04
1179566,인천광역시,5543,0,5440,103,2022-08-04
799431,충청남도,4807,0,4764,43,2022-08-05
652230,전라남도,3887,0,3872,15,2022-08-05
4073752,서울특별시,20817,0,20799,18,2022-08-05
882925,경상북도,5721,0,5685,36,2022-08-06
588611,광주광역시,2845,0,2810,35,2022-08-06
623675,충청북도,3913,0,3891,22,2022-08-06
676211,전라북도,4481,0,4461,20,2022-08-07
808605,충청남도,4470,0,4437,33,2022-08-07
659109,전라남도,3288,0,3285,3,2022-08-07
443994,울산광역시,1604,0,1593,11,2022-08-08
160394,세종특별자치시,1327,0,1318,9,2022-08-10
823433,충청남도,6642,0,6619,23,2022-08-10
604112,강원도,5275,0,5252,23,2022-08-10
913773,경상북도,7126,0,7086,40,2022-08-11
1259054,부산광역시,8190,0,8186,4,2022-08-11
5721871,경기도,32748,0,32706,42,2022-08-12
290315,제주특별자치도,1984,0,1968,16,2022-08-12
1256882,경상남도,7768,0,7727,41,2022-08-12
4222976,서울특별시,22835,0,22822,13,2022-08-12
682601,전라남도,5235,0,5225,10,2022-08-12
705327,전라북도,4802,0,4778,24,2022-08-13
1264644,경상남도,7764,0,7720,44,2022-08-13
163494,세종특별자치시,1064,0,1051,13,2022-08-13
617016,강원도,3987,0,3965,22,2022-08-13
693016,전라남도,5026,0,5014,12,2022-08-14
607484,대전광역시,4112,0,4073,39,2022-08-14
609747,대전광역시,2263,0,2233,30,2022-08-15
307031,제주특별자치도,1934,0,1920,14,2022-08-21
1332140,경상남도,7602,0,7565,37,2022-08-21
884890,충청남도,5186,0,5148,38,2022-08-21
745351,전라북도,4727,0,4705,22,2022-08-21
747879,전라북도,2528,0,2510,18,2022-08-22
6013003,경기도,15000,0,14976,24,2022-08-22
4411616,서울특별시,7395,0,7376,19,2022-08-22
887367,충청남도,2477,0,2453,24,2022-08-22
654813,광주광역시,2661,0,2646,15,2022-08-22
639545,대전광역시,2055,0,2026,29,2022-08-22
309916,제주특별자치도,1531,0,1521,10,2022-08-23
1350436,부산광역시,10689,0,10680,9,2022-08-23
653722,강원도,4167,0,4154,13,2022-08-23
6082856,경기도,32651,0,32608,43,2022-08-24
174722,세종특별자치시,1171,0,1164,7,2022-08-24
4457827,서울특별시,20578,0,20569,9,2022-08-24
658348,강원도,4628,0,4610,18,2022-08-24
905743,충청남도,5241,0,5206,35,2022-08-25
1366157,부산광역시,7164,0,7163,1,2022-08-25
751438,전라남도,5081,0,5074,7,2022-08-25
967218,대구광역시,6307,0,6293,14,2022-08-25
1308817,인천광역시,5796,0,5729,67,2022-08-25
763330,전라북도,4533,0,4482,51,2022-08-25
910665,충청남도,4922,0,4901,21,2022-08-26
755797,전라남도,4362,0,4355,7,2022-08-26
176576,세종특별자치시,911,0,909,2,2022-08-26
672553,광주광역시,3690,0,3672,18,2022-08-26
1319055,인천광역시,4818,0,4718,100,2022-08-27
4505836,서울특별시,14599,0,14578,21,2022-08-27
1018139,경상북도,5371,0,5352,19,2022-08-27
177409,세종특별자치시,833,0,830,3,2022-08-27
1383728,경상남도,6137,0,6099,38,2022-08-28
4518888,서울특별시,13052,0,13045,7,2022-08-28
712399,충청북도,2979,0,2964,15,2022-08-28
1026112,경상북도,2761,0,2728,33,2022-08-29
776420,전라북도,1559,0,1537,22,2022-08-29
663332,대전광역시,1563,0,1527,36,2022-08-29
926522,충청남도,5304,0,5292,12,2022-08-30
683592,광주광역시,2953,0,2943,10,2022-08-30
1031052,경상북도,4940,0,4897,43,2022-08-30
784662,전라북도,4287,0,4255,32,2022-08-31
1400836,경상남도,6779,0,6746,33,2022-08-31
1406209,경상남도,5373,0,5362,11,2022-09-01
1000958,대구광역시,4135,0,4125,10,2022-09-01
1416103,부산광역시,3685,0,3685,0,2022-09-04
681041,대전광역시,2342,0,2332,10,2022-09-04
183548,세종특별자치시,719,0,716,3,2022-09-04
948315,충청남도,1635,0,1625,10,2022-09-05
682339,대전광역시,1298,0,1292,6,2022-09-05
514430,울산광역시,1692,0,1687,5,2022-09-06
691805,강원도,2819,0,2812,7,2022-09-06
184874,세종특별자치시,962,0,961,1,2022-09-06
325546,제주특별자치도,567,0,560,7,2022-09-06
1026671,대구광역시,5362,0,5350,12,2022-09-07
741402,충청북도,3148,0,3137,11,2022-09-07
1068011,경상북도,5316,0,5284,32,2022-09-07
688143,대전광역시,2538,0,2522,16,2022-09-07
326956,제주특별자치도,723,0,719,4,2022-09-08
6407991,경기도,19292,0,19277,15,2022-09-08
1439985,경상남도,4751,0,4739,12,2022-09-08
517208,울산광역시,1411,0,1408,3,2022-09-08
1377294,인천광역시,4105,0,4028,77,2022-09-09
327628,제주특별자치도,672,0,662,10,2022-09-09
746358,충청북도,2474,0,2460,14,2022-09-09
1075802,경상북도,3857,0,3834,23,2022-09-09
700589,강원도,1458,0,1450,8,2022-09-10
709470,광주광역시,1562,0,1558,4,2022-09-10
1078741,경상북도,2939,0,2920,19,2022-09-10
1447560,경상남도,2991,0,2978,13,2022-09-10
328326,제주특별자치도,323,0,318,5,2022-09-11
749311,충청북도,1117,0,1113,4,2022-09-11
965925,충청남도,1269,0,1253,16,2022-09-11
711222,광주광역시,883,0,882,1,2022-09-12
328613,제주특별자치도,287,0,284,3,2022-09-12
1441719,부산광역시,3200,0,3195,5,2022-09-13
1386901,인천광역시,3407,0,3325,82,2022-09-13
974079,충청남도,3725,0,3699,26,2022-09-14
4723634,서울특별시,17384,0,17368,16,2022-09-14
1048878,대구광역시,5360,0,5351,9,2022-09-14
755791,충청북도,3166,0,3143,23,2022-09-14
189344,세종특별자치시,844,0,838,6,2022-09-14
703472,대전광역시,1940,0,1925,15,2022-09-15
1396709,인천광역시,4271,0,4184,87,2022-09-15
760209,충청북도,1728,0,1717,11,2022-09-16
6528289,경기도,13857,0,13823,34,2022-09-16
1097184,경상북도,3032,0,3007,25,2022-09-16
4744665,서울특별시,9225,0,9207,18,2022-09-16
1399833,인천광역시,3127,0,3049,78,2022-09-16
1058005,대구광역시,2477,0,2472,5,2022-09-17
706339,대전광역시,1273,0,1260,13,2022-09-17
826506,전라북도,1673,0,1659,14,2022-09-17
330632,제주특별자치도,352,0,350,2,2022-09-17
1101871,경상북도,2174,0,2163,11,2022-09-18
6548904,경기도,9018,0,9002,16,2022-09-18
982709,충청남도,1511,0,1495,16,2022-09-18
526796,울산광역시,293,0,293,0,2022-09-19
331125,제주특별자치도,223,0,218,5,2022-09-19
191189,세종특별자치시,208,0,206,2,2022-09-19
983626,충청남도,917,0,911,6,2022-09-19
331393,제주특별자치도,268,0,259,9,2022-09-20
814473,전라남도,1409,0,1399,10,2022-09-20
709456,대전광역시,1507,0,1494,13,2022-09-20
830094,전라북도,1625,0,1610,15,2022-09-20
710617,대전광역시,1161,0,1141,20,2022-09-21
528209,울산광역시,737,0,731,6,2022-09-21
725659,광주광역시,776,0,768,8,2022-09-23
6596802,경기도,8187,0,8131,56,2022-09-23
192435,세종특별자치시,256,0,254,2,2022-09-23
1110949,경상북도,1627,0,1610,17,2022-09-23
1483914,경상남도,1642,0,1624,18,2022-09-23
332217,제주특별자치도,206,0,201,5,2022-09-23
1485682,경상남도,1768,0,1757,11,2022-09-24
1112596,경상북도,1648,0,1634,14,2022-09-24
192861,세종특별자치시,195,0,192,3,2022-09-25
332678,제주특별자치도,194,0,187,7,2022-09-25
1418787,인천광역시,1713,0,1636,77,2022-09-25
1466257,부산광역시,1156,0,1148,8,2022-09-25
820781,전라남도,1119,0,1114,5,2022-09-27
4811733,서울특별시,8557,0,8538,19,2022-09-27
333020,제주특별자치도,190,0,188,2,2022-09-27
1074719,대구광역시,2056,0,2051,5,2022-09-27
728341,광주광역시,830,0,822,8,2022-09-27
1419721,인천광역시,934,0,866,68,2022-09-26
995831,충청남도,1483,0,1472,11,2022-09-28
1424273,인천광역시,2089,0,1998,91,2022-09-28
724314,강원도,1313,0,1300,13,2022-09-28
531517,울산광역시,625,0,620,5,2022-09-28
4825107,서울특별시,6270,0,6250,20,2022-09-29
1471654,부산광역시,1417,0,1412,5,2022-09-29
1120170,경상북도,1532,0,1523,9,2022-09-29
4830891,서울특별시,5794,0,5783,11,2022-09-30
1427879,인천광역시,1749,0,1681,68,2022-09-30
6654815,경기도,8169,0,8132,37,2022-09-30
194077,세종특별자치시,218,0,212,6,2022-09-30
730758,광주광역시,651,0,642,9,2022-09-30
776166,충청북도,823,0,812,11,2022-10-01
727216,강원도,900,0,894,6,2022-10-01
334102,제주특별자치도,171,0,164,7,2022-10-02
727896,강원도,680,0,677,3,2022-10-02
777340,충청북도,383,0,378,5,2022-10-03
1475687,부산광역시,431,0,429,2,2022-10-03
1000583,충청남도,468,0,463,5,2022-10-03
842019,전라북도,286,0,282,4,2022-10-03
194620,세종특별자치시,111,0,106,5,2022-10-03
6673269,경기도,3781,0,3773,8,2022-10-03
719704,대전광역시,337,0,333,4,2022-10-03
533603,울산광역시,189,0,189,0,2022-10-03
1431562,인천광역시,785,0,778,7,2022-10-03
1476381,부산광역시,694,0,691,3,2022-10-04
842541,전라북도,522,0,521,1,2022-10-04
334388,제주특별자치도,144,0,144,0,2022-10-04
1002577,충청남도,1328,0,1328,0,2022-10-05
6687888,경기도,9838,0,9829,9,2022-10-05
534501,울산광역시,540,0,540,0,2022-10-05
4854042,서울특별시,7674,0,7671,3,2022-10-05
334835,제주특별자치도,258,0,256,2,2022-10-06
733948,광주광역시,681,0,680,1,2022-10-06
731241,강원도,1125,0,1120,5,2022-10-06
535433,울산광역시,354,0,354,0,2022-10-07
845136,전라북도,698,0,697,1,2022-10-07
734469,광주광역시,521,0,519,2,2022-10-07
1130593,경상북도,1285,0,1280,5,2022-10-07
1131700,경상북도,1109,0,1107,2,2022-10-08
1005173,충청남도,755,0,752,3,2022-10-08
6707127,경기도,5328,0,5321,7,2022-10-08
734943,광주광역시,474,0,470,4,2022-10-08
845791,전라북도,656,0,656,0,2022-10-08
735365,광주광역시,422,0,422,0,2022-10-09
195755,세종특별자치시,133,0,133,0,2022-10-09
782398,충청북도,349,0,349,0,2022-10-10
195832,세종특별자치시,77,0,76,1,2022-10-10
846671,전라북도,302,0,302,0,2022-10-10
1440981,인천광역시,941,0,929,12,2022-10-11
1134013,경상북도,732,0,730,2,2022-10-11
829476,전라남도,467,0,467,0,2022-10-11
735936,광주광역시,338,0,338,0,2022-10-11
847159,전라북도,488,0,486,2,2022-10-11
4875900,서울특별시,3054,0,3052,2,2022-10-11
724141,대전광역시,472,0,469,3,2022-10-11
782917,충청북도,519,0,518,1,2022-10-11
536641,울산광역시,345,0,342,3,2022-10-11
1007867,충청남도,1031,0,1029,2,2022-10-12
4887950,서울특별시,5254,0,5251,3,2022-10-13
784897,충청북도,1038,0,1036,2,2022-10-13
848860,전라북도,822,0,821,1,2022-10-13
1138656,경상북도,1461,0,1460,1,2022-10-14
4897351,서울특별시,4579,0,4575,4,2022-10-15
336311,제주특별자치도,191,0,190,1,2022-10-15
1488662,부산광역시,1179,0,1178,1,2022-10-15
738801,광주광역시,566,0,565,1,2022-10-16
738716,강원도,737,0,735,2,2022-10-16
1448599,인천광역시,1287,0,1281,6,2022-10-16
1514438,경상남도,1037,0,1034,3,2022-10-16
4903463,서울특별시,1921,0,1920,1,2022-10-17
739214,강원도,498,0,498,0,2022-10-17
739059,광주광역시,258,0,258,0,2022-10-17
832944,전라남도,291,0,291,0,2022-10-17
336599,제주특별자치도,128,0,127,1,2022-10-17
1516621,경상남도,1611,0,1606,5,2022-10-18
833729,전라남도,788,0,788,0,2022-10-18
729117,대전광역시,986,0,978,8,2022-10-18
740411,광주광역시,678,0,678,0,2022-10-19
834395,전라남도,666,0,662,4,2022-10-19
1101471,대구광역시,1117,0,1115,2,2022-10-20
1494354,부산광역시,1098,0,1097,1,2022-10-20
854432,전라북도,706,0,704,2,2022-10-21
835568,전라남도,589,0,588,1,2022-10-21
790780,충청북도,769,0,769,0,2022-10-21
732284,대전광역시,808,0,804,4,2022-10-22
742282,광주광역시,635,0,635,0,2022-10-22
1496774,부산광역시,1220,0,1218,2,2022-10-22
1459790,인천광역시,1660,0,1655,5,2022-10-23
1522798,경상남도,1283,0,1279,4,2022-10-23
198428,세종특별자치시,132,0,132,0,2022-10-24
743237,광주광역시,344,0,344,0,2022-10-24
1107304,대구광역시,1831,0,1831,0,2022-10-25
735060,대전광역시,1443,0,1439,4,2022-10-25
1021643,충청남도,1570,0,1568,2,2022-10-26
736224,대전광역시,1164,0,1161,3,2022-10-26
796507,충청북도,1075,0,1074,1,2022-10-27
1022935,충청남도,1302,0,1301,1,2022-10-27
859632,전라북도,1003,0,1002,1,2022-10-27
737300,대전광역시,1076,0,1072,4,2022-10-27
338335,제주특별자치도,178,0,178,0,2022-10-27
860648,전라북도,1018,0,1016,2,2022-10-28
751528,강원도,1394,0,1393,1,2022-10-28
4980775,서울특별시,7578,0,7577,1,2022-10-29
1532337,경상남도,1666,0,1666,0,2022-10-29
1472754,인천광역시,2325,0,2325,0,2022-10-29
752908,강원도,1380,0,1378,2,2022-10-29
747626,광주광역시,874,0,872,2,2022-10-29
547135,울산광역시,637,0,636,1,2022-10-30
863344,전라북도,591,0,591,0,2022-10-31
6875924,경기도,9691,0,9688,3,2022-10-31
547135,울산광역시,637,0,636,1,2022-10-31
755021,강원도,840,0,840,0,2022-10-31
200511,세종특별자치시,329,0,328,1,2022-10-31
800772,충청북도,633,0,631,2,2022-10-31
1115802,대구광역시,1704,0,1703,1,2022-10-31
4987483,서울특별시,6708,0,6707,1,2022-10-31
1479896,인천광역시,3748,0,3745,3,2022-11-01
5003593,서울특별시,13017,0,13016,1,2022-11-01
750063,광주광역시,1095,0,1094,1,2022-11-01
339734,제주특별자치도,359,0,359,0,2022-11-02
1483200,인천광역시,3306,0,3299,7,2022-11-02
1121410,대구광역시,2420,0,2417,3,2022-11-02
751389,광주광역시,1326,0,1325,1,2022-11-02
759274,강원도,2271,0,2268,3,2022-11-02
1541784,경상남도,2134,0,2133,1,2022-11-03
1173083,경상북도,2612,0,2610,2,2022-11-03
754612,광주광역시,975,0,975,0,2022-11-05
6963583,경기도,10433,0,10430,3,2022-11-06
6969861,경기도,6278,0,6278,0,2022-11-07
1039863,충청남도,730,0,730,0,2022-11-07
1129278,대구광역시,646,0,644,2,2022-11-07
204087,세종특별자치시,658,0,657,1,2022-11-08
341178,제주특별자치도,266,0,266,0,2022-11-08
757290,광주광역시,1214,0,1213,1,2022-11-08
758867,광주광역시,1577,0,1577,0,2022-11-09
1558578,경상남도,2523,0,2519,4,2022-11-11
5099934,서울특별시,10903,0,10903,0,2022-11-11
1508963,인천광역시,3603,0,3603,0,2022-11-11
879042,전라북도,1650,0,1650,0,2022-11-11
1142008,대구광역시,2429,0,2422,7,2022-11-12
760308,대전광역시,1898,0,1898,0,2022-11-12
1563568,경상남도,2321,0,2321,0,2022-11-13
1540263,부산광역시,2365,0,2365,0,2022-11-13
778225,강원도,1570,0,1570,0,2022-11-13
825788,충청북도,2153,0,2153,0,2022-11-15
1545755,부산광역시,4541,0,4540,1,2022-11-15
887440,전라북도,2246,0,2243,3,2022-11-16
1572161,경상남도,3412,0,3408,4,2022-11-16
1205366,경상북도,3669,0,3664,5,2022-11-16
864750,전라남도,1361,0,1360,1,2022-11-17
7129906,경기도,15694,0,15691,3,2022-11-17
769401,대전광역시,1831,0,1831,0,2022-11-17
889192,전라북도,1752,0,1752,0,2022-11-17
1210733,경상북도,2605,0,2600,5,2022-11-18
1070448,충청남도,958,0,958,0,2022-11-21
835499,충청북도,685,0,685,0,2022-11-21
1565668,부산광역시,4593,0,4590,3,2022-11-22
899180,전라북도,2248,0,2247,1,2022-11-23
346387,제주특별자치도,444,0,443,1,2022-11-23
781223,대전광역시,1878,0,1878,0,2022-11-24
1569694,부산광역시,3252,0,3251,1,2022-11-24
7249520,경기도,14786,0,14786,0,2022-11-25
573341,울산광역시,342,0,341,1,2022-11-28
7283855,경기도,6691,0,6689,2,2022-11-28
1237986,경상북도,2671,0,2668,3,2022-11-29
574600,울산광역시,1259,0,1258,1,2022-11-29
1608354,경상남도,3930,0,3928,2,2022-11-29
5318646,서울특별시,10487,0,10487,0,2022-12-02
1098784,충청남도,2268,0,2268,0,2022-12-03
1623266,경상남도,2455,0,2454,1,2022-12-04
5383532,서울특별시,11977,0,11975,2,2022-12-08
352621,제주특별자치도,574,0,574,0,2022-12-09
818906,광주광역시,2325,0,2324,1,2022-12-15
886984,충청북도,1042,0,1041,1,2022-12-19
1675201,부산광역시,5139,0,5137,2,2022-12-22
5588542,서울특별시,10508,0,10507,1,2022-12-25
935057,전라남도,942,0,936,6,2022-12-26
5626635,서울특별시,15783,0,15783,0,2022-12-28
7851658,경기도,17945,0,17933,12,2022-12-30
6126,전라남도,48,5404,47,1,2022-01-01
36962,인천광역시,241,30703,239,2,2022-01-01
7101,울산광역시,48,6570,47,1,2022-01-05
21343,경상남도,114,19280,111,3,2022-01-05
23739,대구광역시,110,22066,106,4,2022-01-06
26511,부산광역시,207,23228,204,3,2022-01-07
23946,대구광역시,108,22340,104,4,2022-01-08
2265,세종특별자치시,13,2113,13,0,2022-01-09
236192,서울특별시,781,190067,718,63,2022-01-10
12134,충청북도,54,11375,53,1,2022-01-11
10724,전라북도,102,9756,99,3,2022-01-14
2365,세종특별자치시,7,2228,5,2,2022-01-17
40430,인천광역시,200,35422,187,13,2022-01-17
213160,경기도,2176,167630,2116,60,2022-01-19
244565,서울특별시,1231,199738,1125,106,2022-01-19
14357,강원도,99,12971,87,12,2022-01-22
220435,경기도,2426,168420,2383,43,2022-01-22
29239,부산광역시,292,26707,287,5,2022-01-23
14249,대전광역시,226,12045,221,5,2022-01-25
44350,인천광역시,670,36665,653,17,2022-01-25
257330,서울특별시,3178,208356,3110,68,2022-01-26
237491,경기도,4765,169935,4738,27,2022-01-27
2790,세종특별자치시,59,2387,58,1,2022-01-28
10736,전라남도,320,5886,313,7,2022-01-30
50430,인천광역시,1316,38039,1306,10,2022-01-30
32085,대구광역시,908,25631,902,6,2022-01-30
15696,충청북도,410,13032,405,5,2022-02-01
9591,울산광역시,300,7661,296,4,2022-02-02
17129,전라북도,947,11933,944,3,2022-02-03
62492,인천광역시,2238,42391,2227,11,2022-02-06
11406,울산광역시,593,11999,592,1,2022-02-07
20486,전라북도,1271,21756,1269,2,2022-02-07
22529,광주광역시,1241,11796,1237,4,2022-02-08
7706,제주특별자치도,412,5443,412,0,2022-02-09
75776,인천광역시,3996,44778,3990,6,2022-02-10
27127,대전광역시,1423,13946,1422,1,2022-02-11
378200,경기도,17976,222415,17925,51,2022-02-11
28638,대전광역시,1511,14043,1509,2,2022-02-12
24839,전라남도,1264,6927,1259,5,2022-02-14
35912,대전광역시,2590,14176,2589,1,2022-02-16
35428,광주광역시,2298,13335,2294,4,2022-02-16
29650,강원도,1784,19885,1758,26,2022-02-16
31379,강원도,1729,20795,1727,2,2022-02-17
38040,광주광역시,2612,13335,2608,4,2022-02-17
44625,대전광역시,3032,15400,3030,2,2022-02-19
17182,제주특별자치도,1081,10636,1081,0,2022-02-21
655560,경기도,29562,230244,29558,4,2022-02-22
96234,경상남도,8023,56646,8016,7,2022-02-23
57569,대전광역시,4078,17009,4076,2,2022-02-23
68617,전라북도,4161,35458,4156,5,2022-02-26
57567,강원도,3380,28233,3375,5,2022-02-27
27890,제주특별자치도,2167,15597,2165,2,2022-02-27
49618,울산광역시,2485,25453,2485,0,2022-02-28
29696,제주특별자치도,1806,15597,1806,0,2022-02-28
242903,인천광역시,12105,85945,12104,1,2022-03-02
116340,경상북도,6533,39137,6529,4,2022-03-03
953906,서울특별시,59269,321219,59269,0,2022-03-04
47842,제주특별자치도,3691,27683,3691,0,2022-03-06
122609,광주광역시,6474,14494,6465,9,2022-03-07
111483,전라남도,7957,6956,7953,4,2022-03-09
92536,울산광역시,6582,57385,6582,0,2022-03-09
190871,충청남도,10798,35669,10798,0,2022-03-11
128930,전라남도,8987,6956,8984,3,2022-03-11
199346,전라남도,18958,6965,18957,1,2022-03-17
226823,강원도,6610,82795,6607,3,2022-03-21
291231,충청북도,12587,190741,12586,1,2022-03-24
138052,제주특별자치도,4789,105275,4789,0,2022-03-25
803861,부산광역시,16705,283091,0,16705,2022-03-25
377293,광주광역시,8033,0,8032,1,2022-04-02
190715,제주특별자치도,2855,0,2855,0,2022-04-08
111103,세종특별자치시,1891,0,1891,0,2022-04-08
409502,대전광역시,7005,0,7005,0,2022-04-09
193454,제주특별자치도,2739,0,2739,0,2022-04-09
418582,대전광역시,3677,0,3677,0,2022-04-11
937699,경상남도,12563,0,12561,2,2022-04-12
990236,부산광역시,9610,0,9610,0,2022-04-12
949038,경상남도,11340,0,11336,4,2022-04-13
431914,대전광역시,6516,0,6512,4,2022-04-13
645593,경상북도,6713,0,6712,1,2022-04-15
503795,전라남도,5721,0,5721,0,2022-04-15
511431,전라북도,5344,0,5343,1,2022-04-15
445413,대전광역시,3836,0,3836,0,2022-04-16
483847,충청북도,4151,0,4149,2,2022-04-16
985503,인천광역시,4874,0,4874,0,2022-04-17
637265,충청남도,5471,0,5470,1,2022-04-19
458072,대전광역시,3891,0,3891,0,2022-04-20
501007,충청북도,3509,0,3507,2,2022-04-21
1008857,인천광역시,4098,0,4098,0,2022-04-22
126843,세종특별자치시,570,0,570,0,2022-04-22
347040,울산광역시,1689,0,1689,0,2022-04-24
347729,울산광역시,689,0,689,0,2022-04-25
128936,세종특별자치시,666,0,666,0,2022-04-26
550483,전라북도,3515,0,3514,1,2022-04-26
497219,광주광역시,3054,0,3053,1,2022-04-27
478821,강원도,1840,0,1838,2,2022-04-29
675327,충청남도,1821,0,1821,0,2022-05-01
4734258,경기도,5341,0,5341,0,2022-05-02
715274,대구광역시,3246,0,3246,0,2022-05-03
3498346,서울특별시,8709,0,8709,0,2022-05-03
133403,세종특별자치시,152,0,152,0,2022-05-09
227524,제주특별자치도,405,0,405,0,2022-05-10
1071453,부산광역시,1997,0,1997,0,2022-05-11
541063,충청북도,1086,0,1081,5,2022-05-14
1067902,경상남도,1734,0,1734,0,2022-05-15
1072890,경상남도,1929,0,1926,3,2022-05-18
545883,충청북도,1022,0,1020,2,2022-05-19
4875504,경기도,6863,0,6863,0,2022-05-19
1076155,경상남도,1509,0,1506,3,2022-05-20
232591,제주특별자치도,258,0,258,0,2022-05-23
512487,강원도,660,0,658,2,2022-05-27
754641,대구광역시,1015,0,1015,0,2022-05-27
531105,광주광역시,202,0,196,6,2022-05-30
3616699,서울특별시,3340,0,3339,1,2022-05-31
775325,경상북도,966,0,964,2,2022-05-31
1093144,부산광역시,707,0,707,0,2022-06-01
531998,광주광역시,462,0,458,4,2022-06-01
516301,강원도,586,0,585,1,2022-06-03
235756,제주특별자치도,210,0,210,0,2022-06-04
379019,울산광역시,331,0,330,1,2022-06-04
1091517,경상남도,688,0,686,2,2022-06-04
715549,충청남도,193,0,193,0,2022-06-06
1092766,경상남도,409,0,408,1,2022-06-07
517778,강원도,307,0,307,0,2022-06-07
518365,강원도,587,0,587,0,2022-06-08
764196,대구광역시,673,0,671,2,2022-06-09
518905,강원도,540,0,539,1,2022-06-09
534681,광주광역시,226,0,225,1,2022-06-11
381307,울산광역시,297,0,294,3,2022-06-12
1098770,부산광역시,188,0,188,0,2022-06-13
602214,전라북도,109,0,106,3,2022-06-13
557615,충청북도,102,0,98,4,2022-06-13
785389,경상북도,579,0,578,1,2022-06-14
4955893,경기도,2348,0,2346,2,2022-06-14
786633,경상북도,558,0,557,1,2022-06-16
1078815,인천광역시,260,0,250,10,2022-06-18
535876,광주광역시,135,0,130,5,2022-06-18
382825,울산광역시,244,0,244,0,2022-06-18
3648259,서울특별시,719,0,717,2,2022-06-20
522477,강원도,154,0,154,0,2022-06-20
559395,충청북도,235,0,231,4,2022-06-21
383499,울산광역시,317,0,315,2,2022-06-21
140144,세종특별자치시,76,0,67,9,2022-06-22
3652068,서울특별시,1778,0,1777,1,2022-06-22
4974445,경기도,1862,0,1858,4,2022-06-24
560443,충청북도,85,0,80,5,2022-06-27
4981389,경기도,2583,0,2571,12,2022-06-28
560894,충청북도,231,0,209,22,2022-06-29
4988935,경기도,2463,0,2453,10,2022-07-01
1107113,부산광역시,586,0,586,0,2022-07-01
1104875,경상남도,576,0,571,5,2022-07-02
140751,세종특별자치시,79,0,78,1,2022-07-02
4994412,경기도,2663,0,2637,26,2022-07-03
3673484,서울특별시,2440,0,2437,3,2022-07-03
562022,충청북도,166,0,160,6,2022-07-04
602983,전라남도,148,0,147,1,2022-07-04
1108558,부산광역시,291,0,291,0,2022-07-04
774035,대구광역시,253,0,242,11,2022-07-04
240132,제주특별자치도,285,0,275,10,2022-07-05
1110890,부산광역시,1164,0,1162,2,2022-07-06
527404,강원도,596,0,581,15,2022-07-06
1115858,부산광역시,1297,0,1286,11,2022-07-10
605534,전라남도,440,0,439,1,2022-07-10
520941,대전광역시,524,0,521,3,2022-07-10
1112756,경상남도,658,0,642,16,2022-07-11
142217,세종특별자치시,320,0,317,3,2022-07-12
730182,충청남도,1289,0,1278,11,2022-07-12
1096026,인천광역시,2097,0,2021,76,2022-07-13
395639,울산광역시,1178,0,1171,7,2022-07-16
3761516,서울특별시,8565,0,8561,4,2022-07-17
249826,제주특별자치도,1221,0,1214,7,2022-07-19
749736,충청남도,2641,0,2627,14,2022-07-22
630615,전라북도,2354,0,2334,20,2022-07-24
147414,세종특별자치시,232,0,224,8,2022-07-25
556754,광주광역시,1106,0,1080,26,2022-07-25
561959,광주광역시,2890,0,2844,46,2022-07-27
643832,전라북도,2921,0,2893,28,2022-07-29
819856,대구광역시,2874,0,2859,15,2022-07-30
151608,세종특별자치시,588,0,581,7,2022-07-31
1199658,경상남도,5815,0,5796,19,2022-08-04
433367,울산광역시,2881,0,2864,17,2022-08-04
276244,제주특별자치도,1895,0,1888,7,2022-08-04
1241953,부산광역시,10011,0,9999,12,2022-08-09
4175643,서울특별시,26068,0,26046,22,2022-08-10
677367,전라남도,5342,0,5319,23,2022-08-11
161446,세종특별자치시,1053,0,1045,8,2022-08-11
835014,충청남도,5747,0,5718,29,2022-08-12
1281110,부산광역시,7008,0,6999,9,2022-08-14
933103,경상북도,6458,0,6415,43,2022-08-14
936687,경상북도,3584,0,3543,41,2022-08-15
484747,울산광역시,2863,0,2856,7,2022-08-21
960914,대구광역시,7895,0,7875,20,2022-08-24
900512,충청남도,6397,0,6366,31,2022-08-24
1358995,부산광역시,8592,0,8591,1,2022-08-24
1314240,인천광역시,5424,0,5336,88,2022-08-26
983019,대구광역시,4910,0,4896,14,2022-08-28
1386300,경상남도,2572,0,2549,23,2022-08-29
1403481,부산광역시,4488,0,4486,2,2022-09-01
1021309,대구광역시,5032,0,5022,10,2022-09-06
6495551,경기도,26133,0,26110,23,2022-09-14
806148,전라남도,2744,0,2739,5,2022-09-14
525849,울산광역시,718,0,715,3,2022-09-17
1060026,대구광역시,2021,0,2016,5,2022-09-18
827869,전라북도,1363,0,1353,10,2022-09-18
1477989,경상남도,2866,0,2841,25,2022-09-20
716414,강원도,1397,0,1379,18,2022-09-20
529665,울산광역시,462,0,459,3,2022-09-24
4795958,서울특별시,5651,0,5635,16,2022-09-24
727511,광주광역시,466,0,463,3,2022-09-26
6616190,경기도,4168,0,4153,15,2022-09-26
835996,전라북도,449,0,441,8,2022-09-26
1118639,경상북도,2036,0,2009,27,2022-09-28
1430777,인천광역시,1343,0,1268,75,2022-10-02
533961,울산광역시,358,0,358,0,2022-10-04
1499935,경상남도,975,0,971,4,2022-10-04
194804,세종특별자치시,184,0,184,0,2022-10-04
721829,대전광역시,742,0,735,7,2022-10-06
335014,제주특별자치도,179,0,178,1,2022-10-07
535799,울산광역시,366,0,365,1,2022-10-08
195622,세종특별자치시,149,0,148,1,2022-10-08
828260,전라남도,502,0,499,3,2022-10-08
536109,울산광역시,310,0,309,1,2022-10-09
1090488,대구광역시,474,0,472,2,2022-10-10
335522,제주특별자치도,123,0,123,0,2022-10-11
1483486,부산광역시,794,0,794,0,2022-10-11
6718831,경기도,4399,0,4397,2,2022-10-11
1509704,경상남도,1545,0,1543,2,2022-10-12
724994,대전광역시,853,0,852,1,2022-10-12
1444508,인천광역시,1658,0,1655,3,2022-10-13
1445918,인천광역시,1410,0,1408,2,2022-10-14
1487485,부산광역시,1113,0,1111,2,2022-10-14
849566,전라북도,706,0,704,2,2022-10-14
196793,세종특별자치시,179,0,179,0,2022-10-15
539318,울산광역시,211,0,211,0,2022-10-17
1011746,충청남도,421,0,418,3,2022-10-17
1013019,충청남도,1283,0,1283,0,2022-10-18
852134,전라북도,898,0,893,5,2022-10-18
336777,제주특별자치도,178,0,178,0,2022-10-18
541014,울산광역시,506,0,505,1,2022-10-20
730705,대전광역시,761,0,759,2,2022-10-20
743478,강원도,942,0,939,3,2022-10-21
1495558,부산광역시,1206,0,1205,1,2022-10-21
733617,대전광역시,450,0,448,2,2022-10-24
838295,전라남도,1028,0,1028,0,2022-10-25
745052,광주광역시,972,0,972,0,2022-10-26
1527359,경상남도,1884,0,1880,4,2022-10-26
4958897,서울특별시,7906,0,7902,4,2022-10-26
738335,대전광역시,1035,0,1030,5,2022-10-28
740552,대전광역시,1035,0,1033,2,2022-10-30
1534676,경상남도,786,0,785,1,2022-10-31
339150,제주특별자치도,161,0,161,0,2022-10-31
5014526,서울특별시,10940,0,10937,3,2022-11-02
761101,강원도,1827,0,1826,1,2022-11-03
869223,전라북도,1290,0,1290,0,2022-11-04
1125129,대구광역시,1953,0,1951,2,2022-11-04
1545558,경상남도,1859,0,1858,1,2022-11-05
340912,제주특별자치도,154,0,154,0,2022-11-07
811140,충청북도,636,0,636,0,2022-11-07
877392,전라북도,1704,0,1704,0,2022-11-10
756629,대전광역시,1785,0,1785,0,2022-11-10
1191972,경상북도,2696,0,2694,2,2022-11-11
882511,전라북도,1768,0,1768,0,2022-11-13
859225,전라남도,1320,0,1320,0,2022-11-13
558970,울산광역시,964,0,964,0,2022-11-13
343186,제주특별자치도,235,0,235,0,2022-11-14
779201,강원도,976,0,976,0,2022-11-14
823635,충청북도,909,0,909,0,2022-11-14
770204,광주광역시,1539,0,1537,2,2022-11-17
866090,전라남도,1340,0,1338,2,2022-11-18
1216878,경상북도,1267,0,1267,0,2022-11-21
774975,광주광역시,549,0,548,1,2022-11-21
210330,세종특별자치시,580,0,580,0,2022-11-22
7218261,경기도,19803,0,19793,10,2022-11-23
1076452,충청남도,3072,0,3072,0,2022-11-23
1597752,경상남도,2915,0,2914,1,2022-11-25
843564,충청북도,1632,0,1632,0,2022-11-25
7264177,경기도,14716,0,14701,15,2022-11-26
802104,강원도,1278,0,1277,1,2022-11-27
1581519,부산광역시,2418,0,2418,0,2022-11-27
348271,제주특별자치도,336,0,336,0,2022-11-29
791195,대전광역시,2047,0,2047,0,2022-11-30
886730,전라남도,1657,0,1655,2,2022-12-02
1620811,경상남도,2727,0,2723,4,2022-12-03
1603322,부산광역시,992,0,990,2,2022-12-05
818103,강원도,2183,0,2179,4,2022-12-07
819958,강원도,1855,0,1855,0,2022-12-08
1619851,부산광역시,3783,0,3783,0,2022-12-09
1598340,인천광역시,3605,0,3603,2,2022-12-09
929839,전라북도,1931,0,1929,2,2022-12-10
1643576,경상남도,3758,0,3755,3,2022-12-10
1118659,충청남도,2252,0,2250,2,2022-12-11
1214272,대구광역시,778,0,778,0,2022-12-12
1607181,인천광역시,1543,0,1540,3,2022-12-12
590251,울산광역시,1781,0,1781,0,2022-12-13
832530,강원도,1975,0,1972,3,2022-12-15
7592942,경기도,18481,0,18474,7,2022-12-16
596529,울산광역시,1404,0,1403,1,2022-12-17
223240,세종특별자치시,223,0,223,0,2022-12-19
827347,대전광역시,2644,0,2644,0,2022-12-20
1298029,경상북도,3901,0,3898,3,2022-12-21
359350,제주특별자치도,945,0,944,1,2022-12-21
955398,전라북도,2555,0,2554,1,2022-12-22
1245088,대구광역시,3197,0,3194,3,2022-12-22
1304161,경상북도,2832,0,2830,2,2022-12-23
837401,대전광역시,1704,0,1701,3,2022-12-25
910483,충청북도,2007,0,2006,1,2022-12-30
230222,세종특별자치시,465,0,464,1,2022-12-31
180575,세종특별자치시,849,0,845,4,2022-08-31
931528,충청남도,5006,0,4971,35,2022-08-31
1427250,부산광역시,3675,0,3670,5,2022-09-07
1430569,부산광역시,3322,0,3317,5,2022-09-08
690422,대전광역시,2279,0,2267,12,2022-09-08
1030602,대구광역시,3931,0,3922,9,2022-09-08
705959,광주광역시,2230,0,2226,4,2022-09-08
699131,강원도,2274,0,2270,4,2022-09-09
1381271,인천광역시,1676,0,1596,80,2022-09-11
4690417,서울특별시,4807,0,4800,7,2022-09-11
1080369,경상북도,1628,0,1619,9,2022-09-11
329930,제주특별자치도,540,0,536,4,2022-09-15
1065709,대구광역시,2132,0,2124,8,2022-09-21
767715,충청북도,1157,0,1147,10,2022-09-22
727045,광주광역시,640,0,636,4,2022-09-25
6126,전라남도,48,5404,47,1,2022-01-01
36962,인천광역시,241,30703,239,2,2022-01-01
7101,울산광역시,48,6570,47,1,2022-01-05
21343,경상남도,114,19280,111,3,2022-01-05
23739,대구광역시,110,22066,106,4,2022-01-06
26511,부산광역시,207,23228,204,3,2022-01-07
23946,대구광역시,108,22340,104,4,2022-01-08
2265,세종특별자치시,13,2113,13,0,2022-01-09
236192,서울특별시,781,190067,718,63,2022-01-10
12134,충청북도,54,11375,53,1,2022-01-11
10724,전라북도,102,9756,99,3,2022-01-14
2365,세종특별자치시,7,2228,5,2,2022-01-17
40430,인천광역시,200,35422,187,13,2022-01-17
213160,경기도,2176,167630,2116,60,2022-01-19
244565,서울특별시,1231,199738,1125,106,2022-01-19
14357,강원도,99,12971,87,12,2022-01-22
220435,경기도,2426,168420,2383,43,2022-01-22
29239,부산광역시,292,26707,287,5,2022-01-23
14249,대전광역시,226,12045,221,5,2022-01-25
44350,인천광역시,670,36665,653,17,2022-01-25
257330,서울특별시,3178,208356,3110,68,2022-01-26
237491,경기도,4765,169935,4738,27,2022-01-27
2790,세종특별자치시,59,2387,58,1,2022-01-28
10736,전라남도,320,5886,313,7,2022-01-30
50430,인천광역시,1316,38039,1306,10,2022-01-30
32085,대구광역시,908,25631,902,6,2022-01-30
15696,충청북도,410,13032,405,5,2022-02-01
9591,울산광역시,300,7661,296,4,2022-02-02
17129,전라북도,947,11933,944,3,2022-02-03
62492,인천광역시,2238,42391,2227,11,2022-02-06
11406,울산광역시,593,11999,592,1,2022-02-07
20486,전라북도,1271,21756,1269,2,2022-02-07
22529,광주광역시,1241,11796,1237,4,2022-02-08
7706,제주특별자치도,412,5443,412,0,2022-02-09
75776,인천광역시,3996,44778,3990,6,2022-02-10
27127,대전광역시,1423,13946,1422,1,2022-02-11
378200,경기도,17976,222415,17925,51,2022-02-11
28638,대전광역시,1511,14043,1509,2,2022-02-12
24839,전라남도,1264,6927,1259,5,2022-02-14
35912,대전광역시,2590,14176,2589,1,2022-02-16
35428,광주광역시,2298,13335,2294,4,2022-02-16
29650,강원도,1784,19885,1758,26,2022-02-16
31379,강원도,1729,20795,1727,2,2022-02-17
38040,광주광역시,2612,13335,2608,4,2022-02-17
44625,대전광역시,3032,15400,3030,2,2022-02-19
17182,제주특별자치도,1081,10636,1081,0,2022-02-21
655560,경기도,29562,230244,29558,4,2022-02-22
96234,경상남도,8023,56646,8016,7,2022-02-23
57569,대전광역시,4078,17009,4076,2,2022-02-23
68617,전라북도,4161,35458,4156,5,2022-02-26
57567,강원도,3380,28233,3375,5,2022-02-27
27890,제주특별자치도,2167,15597,2165,2,2022-02-27
49618,울산광역시,2485,25453,2485,0,2022-02-28
29696,제주특별자치도,1806,15597,1806,0,2022-02-28
242903,인천광역시,12105,85945,12104,1,2022-03-02
116340,경상북도,6533,39137,6529,4,2022-03-03
953906,서울특별시,59269,321219,59269,0,2022-03-04
47842,제주특별자치도,3691,27683,3691,0,2022-03-06
122609,광주광역시,6474,14494,6465,9,2022-03-07
111483,전라남도,7957,6956,7953,4,2022-03-09
92536,울산광역시,6582,57385,6582,0,2022-03-09
190871,충청남도,10798,35669,10798,0,2022-03-11
128930,전라남도,8987,6956,8984,3,2022-03-11
199346,전라남도,18958,6965,18957,1,2022-03-17
226823,강원도,6610,82795,6607,3,2022-03-21
291231,충청북도,12587,190741,12586,1,2022-03-24
138052,제주특별자치도,4789,105275,4789,0,2022-03-25
803861,부산광역시,16705,283091,0,16705,2022-03-25
377293,광주광역시,8033,0,8032,1,2022-04-02
190715,제주특별자치도,2855,0,2855,0,2022-04-08
111103,세종특별자치시,1891,0,1891,0,2022-04-08
409502,대전광역시,7005,0,7005,0,2022-04-09
193454,제주특별자치도,2739,0,2739,0,2022-04-09
418582,대전광역시,3677,0,3677,0,2022-04-11
937699,경상남도,12563,0,12561,2,2022-04-12
990236,부산광역시,9610,0,9610,0,2022-04-12
949038,경상남도,11340,0,11336,4,2022-04-13
431914,대전광역시,6516,0,6512,4,2022-04-13
645593,경상북도,6713,0,6712,1,2022-04-15
503795,전라남도,5721,0,5721,0,2022-04-15
511431,전라북도,5344,0,5343,1,2022-04-15
445413,대전광역시,3836,0,3836,0,2022-04-16
483847,충청북도,4151,0,4149,2,2022-04-16
985503,인천광역시,4874,0,4874,0,2022-04-17
637265,충청남도,5471,0,5470,1,2022-04-19
458072,대전광역시,3891,0,3891,0,2022-04-20
501007,충청북도,3509,0,3507,2,2022-04-21
1008857,인천광역시,4098,0,4098,0,2022-04-22
126843,세종특별자치시,570,0,570,0,2022-04-22
347040,울산광역시,1689,0,1689,0,2022-04-24
347729,울산광역시,689,0,689,0,2022-04-25
128936,세종특별자치시,666,0,666,0,2022-04-26
472793,대전광역시,2478,0,2477,1,2022-04-26
550483,전라북도,3515,0,3514,1,2022-04-26
3446789,서울특별시,13560,0,13559,1,2022-04-26
497219,광주광역시,3054,0,3053,1,2022-04-27
478821,강원도,1840,0,1838,2,2022-04-29
675327,충청남도,1821,0,1821,0,2022-05-01
4734258,경기도,5341,0,5341,0,2022-05-02
715274,대구광역시,3246,0,3246,0,2022-05-03
3498346,서울특별시,8709,0,8709,0,2022-05-03
133403,세종특별자치시,152,0,152,0,2022-05-09
227524,제주특별자치도,405,0,405,0,2022-05-10
1071453,부산광역시,1997,0,1997,0,2022-05-11
541063,충청북도,1086,0,1081,5,2022-05-14
1067902,경상남도,1734,0,1734,0,2022-05-15
1072890,경상남도,1929,0,1926,3,2022-05-18
545883,충청북도,1022,0,1020,2,2022-05-19
4875504,경기도,6863,0,6863,0,2022-05-19
1076155,경상남도,1509,0,1506,3,2022-05-20
232591,제주특별자치도,258,0,258,0,2022-05-23
512487,강원도,660,0,658,2,2022-05-27
754641,대구광역시,1015,0,1015,0,2022-05-27
531105,광주광역시,202,0,196,6,2022-05-30
3616699,서울특별시,3340,0,3339,1,2022-05-31
775325,경상북도,966,0,964,2,2022-05-31
1093144,부산광역시,707,0,707,0,2022-06-01
531998,광주광역시,462,0,458,4,2022-06-01
516301,강원도,586,0,585,1,2022-06-03
235756,제주특별자치도,210,0,210,0,2022-06-04
379019,울산광역시,331,0,330,1,2022-06-04
1091517,경상남도,688,0,686,2,2022-06-04
715549,충청남도,193,0,193,0,2022-06-06
1092766,경상남도,409,0,408,1,2022-06-07
517778,강원도,307,0,307,0,2022-06-07
518365,강원도,587,0,587,0,2022-06-08
764196,대구광역시,673,0,671,2,2022-06-09
518905,강원도,540,0,539,1,2022-06-09
534681,광주광역시,226,0,225,1,2022-06-11
381307,울산광역시,297,0,294,3,2022-06-12
1098770,부산광역시,188,0,188,0,2022-06-13
602214,전라북도,109,0,106,3,2022-06-13
557615,충청북도,102,0,98,4,2022-06-13
785389,경상북도,579,0,578,1,2022-06-14
4955893,경기도,2348,0,2346,2,2022-06-14
786633,경상북도,558,0,557,1,2022-06-16
1078815,인천광역시,260,0,250,10,2022-06-18
535876,광주광역시,135,0,130,5,2022-06-18
382825,울산광역시,244,0,244,0,2022-06-18
3648259,서울특별시,719,0,717,2,2022-06-20
522477,강원도,154,0,154,0,2022-06-20
559395,충청북도,235,0,231,4,2022-06-21
383499,울산광역시,317,0,315,2,2022-06-21
140144,세종특별자치시,76,0,67,9,2022-06-22
3652068,서울특별시,1778,0,1777,1,2022-06-22
4974445,경기도,1862,0,1858,4,2022-06-24
560443,충청북도,85,0,80,5,2022-06-27
4981389,경기도,2583,0,2571,12,2022-06-28
560894,충청북도,231,0,209,22,2022-06-29
4988935,경기도,2463,0,2453,10,2022-07-01
1107113,부산광역시,586,0,586,0,2022-07-01
1104875,경상남도,576,0,571,5,2022-07-02
140751,세종특별자치시,79,0,78,1,2022-07-02
4994412,경기도,2663,0,2637,26,2022-07-03
3673484,서울특별시,2440,0,2437,3,2022-07-03
562022,충청북도,166,0,160,6,2022-07-04
602983,전라남도,148,0,147,1,2022-07-04
1108558,부산광역시,291,0,291,0,2022-07-04
774035,대구광역시,253,0,242,11,2022-07-04
240132,제주특별자치도,285,0,275,10,2022-07-05
1110890,부산광역시,1164,0,1162,2,2022-07-06
527404,강원도,596,0,581,15,2022-07-06
1115858,부산광역시,1297,0,1286,11,2022-07-10
605534,전라남도,440,0,439,1,2022-07-10
520941,대전광역시,524,0,521,3,2022-07-10
1112756,경상남도,658,0,642,16,2022-07-11
142217,세종특별자치시,320,0,317,3,2022-07-12
730182,충청남도,1289,0,1278,11,2022-07-12
1096026,인천광역시,2097,0,2021,76,2022-07-13
395639,울산광역시,1178,0,1171,7,2022-07-16
3761516,서울특별시,8565,0,8561,4,2022-07-17
249826,제주특별자치도,1221,0,1214,7,2022-07-19
749736,충청남도,2641,0,2627,14,2022-07-22
630615,전라북도,2354,0,2334,20,2022-07-24
147414,세종특별자치시,232,0,224,8,2022-07-25
556754,광주광역시,1106,0,1080,26,2022-07-25
561959,광주광역시,2890,0,2844,46,2022-07-27
643832,전라북도,2921,0,2893,28,2022-07-29
819856,대구광역시,2874,0,2859,15,2022-07-30
151608,세종특별자치시,588,0,581,7,2022-07-31
1199658,경상남도,5815,0,5796,19,2022-08-04
433367,울산광역시,2881,0,2864,17,2022-08-04
276244,제주특별자치도,1895,0,1888,7,2022-08-04
1241953,부산광역시,10011,0,9999,12,2022-08-09
4175643,서울특별시,26068,0,26046,22,2022-08-10
677367,전라남도,5342,0,5319,23,2022-08-11
161446,세종특별자치시,1053,0,1045,8,2022-08-11
835014,충청남도,5747,0,5718,29,2022-08-12
1281110,부산광역시,7008,0,6999,9,2022-08-14
933103,경상북도,6458,0,6415,43,2022-08-14
936687,경상북도,3584,0,3543,41,2022-08-15
484747,울산광역시,2863,0,2856,7,2022-08-21
960914,대구광역시,7895,0,7875,20,2022-08-24
900512,충청남도,6397,0,6366,31,2022-08-24
1358995,부산광역시,8592,0,8591,1,2022-08-24
1314240,인천광역시,5424,0,5336,88,2022-08-26
983019,대구광역시,4910,0,4896,14,2022-08-28
1386300,경상남도,2572,0,2549,23,2022-08-29
180575,세종특별자치시,849,0,845,4,2022-08-31
931528,충청남도,5006,0,4971,35,2022-08-31
1403481,부산광역시,4488,0,4486,2,2022-09-01
1021309,대구광역시,5032,0,5022,10,2022-09-06
1427250,부산광역시,3675,0,3670,5,2022-09-07
1430569,부산광역시,3322,0,3317,5,2022-09-08
690422,대전광역시,2279,0,2267,12,2022-09-08
1030602,대구광역시,3931,0,3922,9,2022-09-08
705959,광주광역시,2230,0,2226,4,2022-09-08
699131,강원도,2274,0,2270,4,2022-09-09
1381271,인천광역시,1676,0,1596,80,2022-09-11
4690417,서울특별시,4807,0,4800,7,2022-09-11
1080369,경상북도,1628,0,1619,9,2022-09-11
6495551,경기도,26133,0,26110,23,2022-09-14
806148,전라남도,2744,0,2739,5,2022-09-14
329930,제주특별자치도,540,0,536,4,2022-09-15
525849,울산광역시,718,0,715,3,2022-09-17
1060026,대구광역시,2021,0,2016,5,2022-09-18
827869,전라북도,1363,0,1353,10,2022-09-18
1477989,경상남도,2866,0,2841,25,2022-09-20
716414,강원도,1397,0,1379,18,2022-09-20
1065709,대구광역시,2132,0,2124,8,2022-09-21
767715,충청북도,1157,0,1147,10,2022-09-22
529665,울산광역시,462,0,459,3,2022-09-24
4795958,서울특별시,5651,0,5635,16,2022-09-24
727045,광주광역시,640,0,636,4,2022-09-25
727511,광주광역시,466,0,463,3,2022-09-26
6616190,경기도,4168,0,4153,15,2022-09-26
835996,전라북도,449,0,441,8,2022-09-26
1118639,경상북도,2036,0,2009,27,2022-09-28
1430777,인천광역시,1343,0,1268,75,2022-10-02
533603,울산광역시,189,0,189,0,2022-10-03
533961,울산광역시,358,0,358,0,2022-10-04
1499935,경상남도,975,0,971,4,2022-10-04
194804,세종특별자치시,184,0,184,0,2022-10-04
721829,대전광역시,742,0,735,7,2022-10-06
335014,제주특별자치도,179,0,178,1,2022-10-07
535799,울산광역시,366,0,365,1,2022-10-08
195622,세종특별자치시,149,0,148,1,2022-10-08
828260,전라남도,502,0,499,3,2022-10-08
536109,울산광역시,310,0,309,1,2022-10-09
1090488,대구광역시,474,0,472,2,2022-10-10
782917,충청북도,519,0,518,1,2022-10-11
335522,제주특별자치도,123,0,123,0,2022-10-11
1483486,부산광역시,794,0,794,0,2022-10-11
829476,전라남도,467,0,467,0,2022-10-11
724141,대전광역시,472,0,469,3,2022-10-11
6718831,경기도,4399,0,4397,2,2022-10-11
1509704,경상남도,1545,0,1543,2,2022-10-12
724994,대전광역시,853,0,852,1,2022-10-12
1444508,인천광역시,1658,0,1655,3,2022-10-13
1445918,인천광역시,1410,0,1408,2,2022-10-14
1487485,부산광역시,1113,0,1111,2,2022-10-14
849566,전라북도,706,0,704,2,2022-10-14
196793,세종특별자치시,179,0,179,0,2022-10-15
539318,울산광역시,211,0,211,0,2022-10-17
1011746,충청남도,421,0,418,3,2022-10-17
832944,전라남도,291,0,291,0,2022-10-17
1013019,충청남도,1283,0,1283,0,2022-10-18
852134,전라북도,898,0,893,5,2022-10-18
336777,제주특별자치도,178,0,178,0,2022-10-18
541014,울산광역시,506,0,505,1,2022-10-20
730705,대전광역시,761,0,759,2,2022-10-20
743478,강원도,942,0,939,3,2022-10-21
790780,충청북도,769,0,769,0,2022-10-21
1495558,부산광역시,1206,0,1205,1,2022-10-21
733617,대전광역시,450,0,448,2,2022-10-24
838295,전라남도,1028,0,1028,0,2022-10-25
745052,광주광역시,972,0,972,0,2022-10-26
1527359,경상남도,1884,0,1880,4,2022-10-26
4958897,서울특별시,7906,0,7902,4,2022-10-26
738335,대전광역시,1035,0,1030,5,2022-10-28
740552,대전광역시,1035,0,1033,2,2022-10-30
4987483,서울특별시,6708,0,6707,1,2022-10-31
1534676,경상남도,786,0,785,1,2022-10-31
339150,제주특별자치도,161,0,161,0,2022-10-31
5014526,서울특별시,10940,0,10937,3,2022-11-02
761101,강원도,1827,0,1826,1,2022-11-03
869223,전라북도,1290,0,1290,0,2022-11-04
1125129,대구광역시,1953,0,1951,2,2022-11-04
1545558,경상남도,1859,0,1858,1,2022-11-05
340912,제주특별자치도,154,0,154,0,2022-11-07
811140,충청북도,636,0,636,0,2022-11-07
877392,전라북도,1704,0,1704,0,2022-11-10
756629,대전광역시,1785,0,1785,0,2022-11-10
1191972,경상북도,2696,0,2694,2,2022-11-11
882511,전라북도,1768,0,1768,0,2022-11-13
859225,전라남도,1320,0,1320,0,2022-11-13
558970,울산광역시,964,0,964,0,2022-11-13
343186,제주특별자치도,235,0,235,0,2022-11-14
779201,강원도,976,0,976,0,2022-11-14
823635,충청북도,909,0,909,0,2022-11-14
770204,광주광역시,1539,0,1537,2,2022-11-17
866090,전라남도,1340,0,1338,2,2022-11-18
1216878,경상북도,1267,0,1267,0,2022-11-21
774975,광주광역시,549,0,548,1,2022-11-21
210330,세종특별자치시,580,0,580,0,2022-11-22
7218261,경기도,19803,0,19793,10,2022-11-23
1076452,충청남도,3072,0,3072,0,2022-11-23
1597752,경상남도,2915,0,2914,1,2022-11-25
843564,충청북도,1632,0,1632,0,2022-11-25
7264177,경기도,14716,0,14701,15,2022-11-26
802104,강원도,1278,0,1277,1,2022-11-27
1581519,부산광역시,2418,0,2418,0,2022-11-27
348271,제주특별자치도,336,0,336,0,2022-11-29
791195,대전광역시,2047,0,2047,0,2022-11-30
886730,전라남도,1657,0,1655,2,2022-12-02
1620811,경상남도,2727,0,2723,4,2022-12-03
1603322,부산광역시,992,0,990,2,2022-12-05
818103,강원도,2183,0,2179,4,2022-12-07
819958,강원도,1855,0,1855,0,2022-12-08
1619851,부산광역시,3783,0,3783,0,2022-12-09
1598340,인천광역시,3605,0,3603,2,2022-12-09
929839,전라북도,1931,0,1929,2,2022-12-10
1643576,경상남도,3758,0,3755,3,2022-12-10
1118659,충청남도,2252,0,2250,2,2022-12-11
1214272,대구광역시,778,0,778,0,2022-12-12
1607181,인천광역시,1543,0,1540,3,2022-12-12
590251,울산광역시,1781,0,1781,0,2022-12-13
832530,강원도,1975,0,1972,3,2022-12-15
7592942,경기도,18481,0,18474,7,2022-12-16
596529,울산광역시,1404,0,1403,1,2022-12-17
223240,세종특별자치시,223,0,223,0,2022-12-19
827347,대전광역시,2644,0,2644,0,2022-12-20
1298029,경상북도,3901,0,3898,3,2022-12-21
359350,제주특별자치도,945,0,944,1,2022-12-21
955398,전라북도,2555,0,2554,1,2022-12-22
1245088,대구광역시,3197,0,3194,3,2022-12-22
1304161,경상북도,2832,0,2830,2,2022-12-23
837401,대전광역시,1704,0,1701,3,2022-12-25
910483,충청북도,2007,0,2006,1,2022-12-30
230222,세종특별자치시,465,0,464,1,2022-12-31
47,세종특별자치시,0,47,0,0,2020-06-07
2128,울산광역시,35,1655,35,0,2021-05-07
14547,대구광역시,35,13774,35,0,2021-09-20
2216,강원도,27,1950,27,0,2021-03-25
184,충청북도,1,162,0,1,2020-10-21
5678,인천광역시,13,5449,13,0,2021-05-01
901,제주특별자치도,4,765,4,0,2021-05-19
2256,전라남도,18,2021,18,0,2021-08-13
539,광주광역시,5,510,5,0,2020-11-13
39,전라북도,0,27,0,0,2020-07-23
2995,강원도,16,2740,16,0,2021-05-19
10001,충청북도,105,9068,105,0,2021-12-15
3232,충청북도,6,2987,6,0,2021-06-20
9,전라남도,0,3,0,0,2020-03-31
3545,충청북도,15,3300,15,0,2021-07-21
5280,경상남도,10,5109,8,2,2021-07-03
19,제주특별자치도,0,15,0,0,2020-06-21
123,세종특별자치시,0,103,0,0,2020-12-11
9436,대구광역시,6,9091,6,0,2021-05-09
866327,광주광역시,993,0,992,1,2023-01-13
2558,충청북도,15,2298,15,0,2021-04-25
20222,경기도,134,17856,128,6,2021-02-04
1383,경상북도,0,1304,0,0,2020-06-07
1820903,부산광역시,174,0,174,0,2023-03-06
1590,강원도,9,1318,8,1,2021-01-22
587,광주광역시,9,511,9,0,2020-11-18
68,울산광역시,3,56,2,1,2020-08-18
8115925,경기도,7145,0,7136,9,2023-01-21
3416,부산광역시,13,3104,13,0,2021-03-14
3273,경상북도,7,3059,4,3,2021-03-02
141,부산광역시,0,125,0,0,2020-05-10
47,세종특별자치시,0,46,0,0,2020-05-15
3204,충청남도,19,2989,19,0,2021-05-13
59,제주특별자치도,0,59,0,0,2020-10-19
4839,경상북도,11,4657,10,1,2021-06-18
0,대전광역시,0,0,0,0,2020-02-19
8284,대전광역시,51,7765,51,0,2021-11-24
15,제주특별자치도,0,13,0,0,2020-06-02
2354,경상남도,62,2172,61,1,2021-03-13
1390570,경상북도,924,0,922,2,2023-02-15
2022,전라남도,19,1769,17,2,2021-07-30
6894,대구광역시,0,6667,0,0,2020-06-15
15335,경상남도,99,14298,99,0,2021-12-03
241032,세종특별자치시,47,0,47,0,2023-02-20
1224,울산광역시,13,1072,13,0,2021-04-08
3022,경상북도,5,2713,4,1,2021-02-01
2720,대전광역시,28,2463,28,0,2021-07-03
1596,강원도,6,1341,5,1,2021-01-23
2753,전라북도,23,2454,21,2,2021-07-30
67,강원도,0,56,0,0,2020-07-11
5480,전라남도,43,4608,43,0,2021-12-19
195,충청북도,0,178,0,0,2020-11-07
9280,대전광역시,106,8191,106,0,2021-12-06
7664,대구광역시,21,7183,21,0,2020-12-27
24055,서울특별시,152,19590,150,2,2021-01-30
1,인천광역시,0,1,0,0,2020-02-08
6,강원도,6,0,6,0,2020-02-23
72,강원도,0,64,0,0,2020-07-27
176,충청북도,1,144,0,1,2020-10-05
518,제주특별자치도,0,487,0,0,2021-01-25
1026936,전라북도,427,0,427,0,2023-03-10
144,부산광역시,0,131,0,0,2020-05-23
2247,광주광역시,9,2191,9,0,2021-04-13
1,인천광역시,0,1,0,0,2020-02-10
111298,경기도,873,100989,868,5,2021-11-04
10252,경기도,288,7479,274,14,2020-12-15
1452,세종특별자치시,7,1387,7,0,2021-11-21
0,제주특별자치도,0,0,0,0,2020-02-05
1284,서울특별시,17,911,15,2,2020-06-27
1389646,경상북도,699,0,697,2,2023-02-14
1463,경상남도,21,1110,21,0,2021-01-05
110,대전광역시,6,44,6,0,2020-06-28
13,제주특별자치도,0,6,0,0,2020-04-26
53,제주특별자치도,1,33,1,0,2020-09-12
511,광주광역시,0,500,0,0,2020-10-30
7062,대구광역시,13,6763,13,0,2020-09-02
852276,충청남도,3603,0,3578,25,2022-08-16
4161,충청북도,55,3677,54,1,2021-08-08
8200028,경기도,3128,0,3123,5,2023-02-10
142,제주특별자치도,15,82,15,0,2020-12-16
2792,강원도,8,2572,8,0,2021-05-07
31233,서울특별시,127,28916,125,2,2021-03-25
20138,서울특별시,329,11721,324,5,2021-01-04
5205,대전광역시,58,4207,58,0,2021-08-20
0,충청남도,0,0,0,0,2020-01-28
1804140,부산광역시,1128,0,1127,1,2023-02-09
55,울산광역시,0,52,0,0,2020-07-05
2058,광주광역시,11,1928,11,0,2021-02-26
3406,경상북도,5,3233,5,0,2021-03-21
5064,대전광역시,33,4018,33,0,2021-08-17
173,전라남도,0,157,0,0,2020-10-07
1598,경상북도,2,1531,2,0,2020-11-15
12,서울특별시,0,4,0,0,2020-02-15
886804,대전광역시,282,0,282,0,2023-02-18
141,충청남도,0,121,0,0,2020-04-23
2269,대전광역시,25,2010,25,0,2021-06-09
95,인천광역시,0,69,0,0,2020-05-03
3005,대전광역시,31,2642,31,0,2021-07-13
82961,경기도,502,74041,499,3,2021-09-21
8257016,경기도,3086,0,3086,0,2023-03-04
13814,경상남도,44,13052,44,0,2021-11-14
4512,충청남도,49,3974,48,1,2021-07-21
1000401,전라남도,142,0,138,4,2023-03-06
4578,부산광역시,44,3872,44,0,2021-04-16
181,충청북도,1,161,0,1,2020-10-19
4433,경상남도,45,4079,44,1,2021-05-16
4914,대전광역시,58,3763,58,0,2021-08-13
231,강원도,4,219,4,0,2020-10-13
6926,대구광역시,0,6710,0,0,2020-07-10
5247,경상남도,17,5061,16,1,2021-06-30
1442,경상남도,33,1089,33,0,2021-01-04
751,울산광역시,2,525,2,0,2021-01-06
1588,경상북도,1,1517,0,1,2020-11-02
225,충청북도,0,197,0,0,2020-11-23
6956,대구광역시,2,6752,2,0,2020-08-19
2533,충청남도,9,2387,9,0,2021-03-13
62,제주특별자치도,0,59,0,0,2020-11-15
21,전라북도,0,19,0,0,2020-06-12
5074,울산광역시,27,4788,27,0,2021-09-26
1127,대전광역시,0,1064,0,0,2021-02-10
7273,부산광역시,102,6433,100,2,2021-07-21
4938,전라북도,19,4707,18,1,2021-10-23
144,부산광역시,0,130,0,0,2020-05-17
2197,부산광역시,21,1681,21,0,2021-01-12
61,충청북도,0,55,0,0,2020-06-17
12166,대구광역시,63,11299,57,6,2021-08-08
4851,경기도,50,4367,48,2,2020-10-18
1,전라남도,0,0,0,0,2020-02-15
32,전라남도,0,19,0,0,2020-07-12
981423,전라남도,671,0,671,0,2023-01-25
113,세종특별자치시,0,86,0,0,2020-12-04
9584,대전광역시,185,8242,184,1,2021-12-08
1706,충청북도,16,1536,16,0,2021-02-20
334,전라북도,16,173,16,0,2020-11-30
354,세종특별자치시,2,338,2,0,2021-04-27
2568,울산광역시,8,2356,8,0,2021-05-29
47132,서울특별시,201,44074,199,2,2021-06-17
65,세종특별자치시,0,51,0,0,2020-08-29
7763,인천광역시,81,6861,77,4,2021-07-17
592,대전광역시,10,483,8,2,2020-12-11
37,충청북도,2,8,2,0,2020-03-23
174,부산광역시,1,154,1,0,2020-08-04
7047,대구광역시,4,6757,4,0,2020-08-31
5296,부산광역시,10,4922,10,0,2021-05-12
9442,경상남도,54,8293,52,2,2021-08-23
7678,충청북도,42,7072,41,1,2021-10-25
1062,경상남도,51,734,49,2,2020-12-20
1,서울특별시,0,0,0,0,2020-01-28
297,부산광역시,6,203,6,0,2020-08-30
2044,전라남도,9,1808,9,0,2021-08-01
9571,경상북도,41,9064,40,1,2021-10-28
1340476,대구광역시,517,0,515,2,2023-03-14
189,충청북도,2,174,0,2,2020-10-30
2385,전라북도,3,2260,2,1,2021-07-04
94,인천광역시,1,66,0,1,2020-05-01
5485,서울특별시,22,4842,17,5,2020-10-09
35577,경기도,149,32724,144,5,2021-05-09
57,울산광역시,0,53,0,0,2020-07-22
15,전라남도,0,4,0,0,2020-04-04
87017,서울특별시,556,75998,554,2,2021-09-13
898491,강원도,286,0,285,1,2023-03-04
11698,경기도,249,8081,244,5,2020-12-20
4246,충청북도,47,3731,41,6,2021-08-10
800,전라남도,4,740,4,0,2021-02-18
0,세종특별자치시,0,0,0,0,2020-01-29
112065,서울특별시,355,99205,352,3,2021-10-18
1720,경상북도,5,1582,4,1,2020-12-02
1,세종특별자치시,0,0,0,0,2020-03-05
302,대전광역시,4,215,4,0,2020-09-08
3947,강원도,27,3591,27,0,2021-07-19
38213,서울특별시,182,35044,177,5,2021-05-02
53,울산광역시,0,47,0,0,2020-06-17
36,강원도,0,20,0,0,2020-03-31
6983,대구광역시,5,6755,5,0,2020-08-25
5091,경기도,103,4488,98,5,2020-10-23
82,충청남도,1,0,1,0,2020-03-04
4,전라남도,0,1,0,0,2020-03-03
20,전라남도,0,18,0,0,2020-06-23
1017912,전라북도,578,0,578,0,2023-02-15
1006482,전라북도,1078,0,1078,0,2023-01-26
4079,울산광역시,22,3706,21,1,2021-08-28
3330,충청북도,2,3195,2,0,2021-07-06
8560,경상남도,125,7237,122,3,2021-08-13
243,강원도,2,220,0,2,2020-10-21
46,세종특별자치시,0,19,0,0,2020-04-13
81,제주특별자치도,1,63,0,1,2020-12-01
1089,울산광역시,1,968,1,0,2021-03-13
241575,세종특별자치시,28,0,28,0,2023-02-27
491,충청남도,0,446,0,0,2020-10-09
13377,대구광역시,90,12437,89,1,2021-08-27
5789,강원도,34,5396,33,1,2021-09-11
1324538,경상남도,8841,0,8805,36,2022-08-20
3815,전라남도,19,3562,19,0,2021-11-13
1827451,부산광역시,410,0,409,1,2023-03-21
7199,충청남도,81,6083,77,4,2021-09-03
2941,울산광역시,8,2793,8,0,2021-07-12
4043,강원도,54,3624,54,0,2021-07-21
5370,울산광역시,1,5266,1,0,2021-10-21
4590,인천광역시,20,4292,20,0,2021-03-09
7694,경상북도,24,7275,22,2,2021-09-18
2916,전라북도,20,2612,18,2,2021-08-07
40180,경기도,160,37370,157,3,2021-06-06
494,대전광역시,5,446,5,0,2020-11-30
895546,대전광역시,480,0,480,0,2023-03-21
1824953,부산광역시,540,0,540,0,2023-03-14
9437,강원도,109,8263,108,1,2021-12-07
76242,서울특별시,677,66391,673,4,2021-08-25
1679,광주광역시,44,1345,44,0,2021-01-28
4666,강원도,26,4183,26,0,2021-08-06
947116,충청북도,606,0,606,0,2023-02-02
1366,경상북도,0,1192,0,0,2020-05-07
25,충청북도,1,1,1,0,2020-03-09
8517,대구광역시,14,8158,12,2,2021-02-17
83,충청북도,1,73,1,0,2020-08-16
297,경상남도,0,287,0,0,2020-10-16
492,광주광역시,2,473,0,2,2020-09-27
678,전라남도,9,559,9,0,2021-01-20
1987,경상북도,25,1711,23,2,2020-12-20
463,충청남도,6,334,3,3,2020-09-18
981,충청북도,42,515,42,0,2020-12-25
117,경상남도,0,97,0,0,2020-04-28
1387,경상북도,0,1328,0,0,2020-06-28
4387,강원도,74,3801,74,0,2021-07-28
216,강원도,1,173,1,0,2020-09-13
133513,서울특별시,846,118566,839,7,2021-11-16
1327262,대구광역시,785,0,783,2,2023-02-14
1579,경상남도,19,1248,19,0,2021-01-10
5393,광주광역시,17,5274,14,3,2021-11-02
0,대전광역시,0,0,0,0,2020-02-10
0,전라남도,0,0,0,0,2020-01-26
71,충청북도,0,64,0,0,2020-07-18
7312,충청북도,41,6615,41,0,2021-10-17
657128,울산광역시,148,0,148,0,2023-03-16
4,제주특별자치도,0,1,0,0,2020-03-13
82,세종특별자치시,0,78,0,0,2020-11-05
32862,인천광역시,375,26331,371,4,2021-12-20
463,경기도,15,154,6,9,2020-03-30
1279332,인천광역시,6254,0,6155,99,2022-08-20
896,강원도,27,676,27,0,2020-12-19
17,전라북도,0,10,0,0,2020-04-25
28468,경기도,117,25953,112,5,2021-03-30
76805,경기도,613,67592,603,10,2021-09-10
6925,대구광역시,1,6708,0,1,2020-07-07
897006,강원도,211,0,211,0,2023-02-25
11613,충청남도,57,10673,57,0,2021-11-15
99,전라북도,2,69,0,2,2020-09-13
372225,제주특별자치도,488,0,487,1,2023-01-10
4352,경상북도,15,3979,15,0,2021-05-11
715,경상남도,16,470,15,1,2020-12-06
45,충청북도,0,26,0,0,2020-04-05
6981,경기도,117,5713,112,5,2020-11-27
6383,충청북도,39,5706,39,0,2021-10-01
63,전라북도,5,38,5,0,2020-08-21
1333,경상북도,3,965,3,0,2020-04-12
208,광주광역시,0,170,0,0,2020-08-08
111710,서울특별시,506,98509,503,3,2021-10-17
47,세종특별자치시,0,47,0,0,2020-06-17
10538,대구광역시,3,10157,3,0,2021-06-22
156,전라남도,0,47,0,0,2020-09-05
184,강원도,0,78,0,0,2020-08-29
7,전라북도,0,5,0,0,2020-03-16
3615,충청남도,4,3424,3,1,2021-06-08
5061,경상남도,5,4818,5,0,2021-06-17
772,전라남도,4,716,4,0,2021-02-12
143,충청남도,0,127,0,0,2020-05-03
612,서울특별시,2,220,0,2,2020-04-14
3155,광주광역시,14,2964,12,2,2021-07-19
868581,광주광역시,418,0,415,3,2023-01-16
2835,광주광역시,9,2716,9,0,2021-06-05
1410,경상북도,0,1342,0,0,2020-08-09
1364556,경상북도,1759,0,1756,3,2023-01-18
2138,경상남도,9,2037,9,0,2021-02-19
1175,대전광역시,2,1110,2,0,2021-02-20
220,강원도,1,203,1,0,2020-09-23
854,전라남도,5,758,5,0,2021-02-26
948123,충청북도,524,0,521,3,2023-02-04
7974,부산광역시,102,6814,99,3,2021-07-28
9,제주특별자치도,0,3,0,0,2020-04-03
2581,제주특별자치도,13,2238,12,1,2021-08-29
3084,전라남도,24,2837,24,0,2021-09-30
1330718,대구광역시,226,0,226,0,2023-02-20
1771883,인천광역시,465,0,464,1,2023-02-26
58,강원도,0,51,0,0,2020-06-09
19613,인천광역시,113,17676,112,1,2021-11-02
660,세종특별자치시,6,596,6,0,2021-07-21
2077,서울특별시,90,1571,89,1,2020-08-17
3860,전라남도,19,3595,19,0,2021-11-15
18629,서울특별시,387,10120,383,4,2020-12-30
1016,부산광역시,35,641,33,2,2020-12-07
1530,제주특별자치도,34,1365,34,0,2021-07-21
16473,충청남도,185,13747,184,1,2021-12-20
6487,인천광역시,17,6218,17,0,2021-06-17
1436,경기도,2,1225,1,1,2020-07-21
1637,충청북도,5,1500,4,1,2021-02-13
16250,경기도,303,11687,294,9,2021-01-07
1234,광주광역시,23,915,23,0,2021-01-05
2881,광주광역시,2,2819,1,1,2021-06-18
1288716,부산광역시,4677,0,4670,7,2022-08-16
47,세종특별자치시,0,47,0,0,2020-06-07
2128,울산광역시,35,1655,35,0,2021-05-07
14547,대구광역시,35,13774,35,0,2021-09-20
2216,강원도,27,1950,27,0,2021-03-25
184,충청북도,1,162,0,1,2020-10-21
5678,인천광역시,13,5449,13,0,2021-05-01
901,제주특별자치도,4,765,4,0,2021-05-19
2256,전라남도,18,2021,18,0,2021-08-13
539,광주광역시,5,510,5,0,2020-11-13
39,전라북도,0,27,0,0,2020-07-23
2995,강원도,16,2740,16,0,2021-05-19
10001,충청북도,105,9068,105,0,2021-12-15
3232,충청북도,6,2987,6,0,2021-06-20
9,전라남도,0,3,0,0,2020-03-31
3545,충청북도,15,3300,15,0,2021-07-21
5280,경상남도,10,5109,8,2,2021-07-03
19,제주특별자치도,0,15,0,0,2020-06-21
123,세종특별자치시,0,103,0,0,2020-12-11
9436,대구광역시,6,9091,6,0,2021-05-09
866327,광주광역시,993,0,992,1,2023-01-13
2558,충청북도,15,2298,15,0,2021-04-25
20222,경기도,134,17856,128,6,2021-02-04
1383,경상북도,0,1304,0,0,2020-06-07
1820903,부산광역시,174,0,174,0,2023-03-06
1590,강원도,9,1318,8,1,2021-01-22
587,광주광역시,9,511,9,0,2020-11-18
68,울산광역시,3,56,2,1,2020-08-18
8115925,경기도,7145,0,7136,9,2023-01-21
3416,부산광역시,13,3104,13,0,2021-03-14
3273,경상북도,7,3059,4,3,2021-03-02
141,부산광역시,0,125,0,0,2020-05-10
47,세종특별자치시,0,46,0,0,2020-05-15
3204,충청남도,19,2989,19,0,2021-05-13
59,제주특별자치도,0,59,0,0,2020-10-19
4839,경상북도,11,4657,10,1,2021-06-18
0,대전광역시,0,0,0,0,2020-02-19
8284,대전광역시,51,7765,51,0,2021-11-24
15,제주특별자치도,0,13,0,0,2020-06-02
2354,경상남도,62,2172,61,1,2021-03-13
1390570,경상북도,924,0,922,2,2023-02-15
2022,전라남도,19,1769,17,2,2021-07-30
6894,대구광역시,0,6667,0,0,2020-06-15
15335,경상남도,99,14298,99,0,2021-12-03
241032,세종특별자치시,47,0,47,0,2023-02-20
1224,울산광역시,13,1072,13,0,2021-04-08
3022,경상북도,5,2713,4,1,2021-02-01
2720,대전광역시,28,2463,28,0,2021-07-03
1596,강원도,6,1341,5,1,2021-01-23
2753,전라북도,23,2454,21,2,2021-07-30
67,강원도,0,56,0,0,2020-07-11
5480,전라남도,43,4608,43,0,2021-12-19
195,충청북도,0,178,0,0,2020-11-07
9280,대전광역시,106,8191,106,0,2021-12-06
7664,대구광역시,21,7183,21,0,2020-12-27
24055,서울특별시,152,19590,150,2,2021-01-30
1,인천광역시,0,1,0,0,2020-02-08
6,강원도,6,0,6,0,2020-02-23
72,강원도,0,64,0,0,2020-07-27
176,충청북도,1,144,0,1,2020-10-05
518,제주특별자치도,0,487,0,0,2021-01-25
1026936,전라북도,427,0,427,0,2023-03-10
144,부산광역시,0,131,0,0,2020-05-23
2247,광주광역시,9,2191,9,0,2021-04-13
1,인천광역시,0,1,0,0,2020-02-10
111298,경기도,873,100989,868,5,2021-11-04
10252,경기도,288,7479,274,14,2020-12-15
1452,세종특별자치시,7,1387,7,0,2021-11-21
0,제주특별자치도,0,0,0,0,2020-02-05
1284,서울특별시,17,911,15,2,2020-06-27
1389646,경상북도,699,0,697,2,2023-02-14
1463,경상남도,21,1110,21,0,2021-01-05
110,대전광역시,6,44,6,0,2020-06-28
13,제주특별자치도,0,6,0,0,2020-04-26
53,제주특별자치도,1,33,1,0,2020-09-12
511,광주광역시,0,500,0,0,2020-10-30
7062,대구광역시,13,6763,13,0,2020-09-02
852276,충청남도,3603,0,3578,25,2022-08-16
4161,충청북도,55,3677,54,1,2021-08-08
8200028,경기도,3128,0,3123,5,2023-02-10
142,제주특별자치도,15,82,15,0,2020-12-16
2792,강원도,8,2572,8,0,2021-05-07
31233,서울특별시,127,28916,125,2,2021-03-25
20138,서울특별시,329,11721,324,5,2021-01-04
5205,대전광역시,58,4207,58,0,2021-08-20
0,충청남도,0,0,0,0,2020-01-28
1804140,부산광역시,1128,0,1127,1,2023-02-09
55,울산광역시,0,52,0,0,2020-07-05
2058,광주광역시,11,1928,11,0,2021-02-26
3406,경상북도,5,3233,5,0,2021-03-21
5064,대전광역시,33,4018,33,0,2021-08-17
173,전라남도,0,157,0,0,2020-10-07
1598,경상북도,2,1531,2,0,2020-11-15
12,서울특별시,0,4,0,0,2020-02-15
886804,대전광역시,282,0,282,0,2023-02-18
141,충청남도,0,121,0,0,2020-04-23
2269,대전광역시,25,2010,25,0,2021-06-09
95,인천광역시,0,69,0,0,2020-05-03
3005,대전광역시,31,2642,31,0,2021-07-13
82961,경기도,502,74041,499,3,2021-09-21
8257016,경기도,3086,0,3086,0,2023-03-04
13814,경상남도,44,13052,44,0,2021-11-14
4512,충청남도,49,3974,48,1,2021-07-21
1000401,전라남도,142,0,138,4,2023-03-06
4578,부산광역시,44,3872,44,0,2021-04-16
181,충청북도,1,161,0,1,2020-10-19
4433,경상남도,45,4079,44,1,2021-05-16
4914,대전광역시,58,3763,58,0,2021-08-13
231,강원도,4,219,4,0,2020-10-13
6926,대구광역시,0,6710,0,0,2020-07-10
5247,경상남도,17,5061,16,1,2021-06-30
1442,경상남도,33,1089,33,0,2021-01-04
751,울산광역시,2,525,2,0,2021-01-06
1588,경상북도,1,1517,0,1,2020-11-02
225,충청북도,0,197,0,0,2020-11-23
6956,대구광역시,2,6752,2,0,2020-08-19
2533,충청남도,9,2387,9,0,2021-03-13
62,제주특별자치도,0,59,0,0,2020-11-15
21,전라북도,0,19,0,0,2020-06-12
5074,울산광역시,27,4788,27,0,2021-09-26
1127,대전광역시,0,1064,0,0,2021-02-10
7273,부산광역시,102,6433,100,2,2021-07-21
4938,전라북도,19,4707,18,1,2021-10-23
144,부산광역시,0,130,0,0,2020-05-17
2197,부산광역시,21,1681,21,0,2021-01-12
61,충청북도,0,55,0,0,2020-06-17
12166,대구광역시,63,11299,57,6,2021-08-08
4851,경기도,50,4367,48,2,2020-10-18
1,전라남도,0,0,0,0,2020-02-15
32,전라남도,0,19,0,0,2020-07-12
981423,전라남도,671,0,671,0,2023-01-25
113,세종특별자치시,0,86,0,0,2020-12-04
9584,대전광역시,185,8242,184,1,2021-12-08
1706,충청북도,16,1536,16,0,2021-02-20
334,전라북도,16,173,16,0,2020-11-30
354,세종특별자치시,2,338,2,0,2021-04-27
2568,울산광역시,8,2356,8,0,2021-05-29
47132,서울특별시,201,44074,199,2,2021-06-17
65,세종특별자치시,0,51,0,0,2020-08-29
7763,인천광역시,81,6861,77,4,2021-07-17
592,대전광역시,10,483,8,2,2020-12-11
37,충청북도,2,8,2,0,2020-03-23
174,부산광역시,1,154,1,0,2020-08-04
7047,대구광역시,4,6757,4,0,2020-08-31
5296,부산광역시,10,4922,10,0,2021-05-12
9442,경상남도,54,8293,52,2,2021-08-23
7678,충청북도,42,7072,41,1,2021-10-25
1062,경상남도,51,734,49,2,2020-12-20
1,서울특별시,0,0,0,0,2020-01-28
297,부산광역시,6,203,6,0,2020-08-30
2044,전라남도,9,1808,9,0,2021-08-01
9571,경상북도,41,9064,40,1,2021-10-28
1340476,대구광역시,517,0,515,2,2023-03-14
189,충청북도,2,174,0,2,2020-10-30
2385,전라북도,3,2260,2,1,2021-07-04
94,인천광역시,1,66,0,1,2020-05-01
5485,서울특별시,22,4842,17,5,2020-10-09
35577,경기도,149,32724,144,5,2021-05-09
57,울산광역시,0,53,0,0,2020-07-22
15,전라남도,0,4,0,0,2020-04-04
87017,서울특별시,556,75998,554,2,2021-09-13
898491,강원도,286,0,285,1,2023-03-04
11698,경기도,249,8081,244,5,2020-12-20
4246,충청북도,47,3731,41,6,2021-08-10
800,전라남도,4,740,4,0,2021-02-18
0,세종특별자치시,0,0,0,0,2020-01-29
112065,서울특별시,355,99205,352,3,2021-10-18
1720,경상북도,5,1582,4,1,2020-12-02
1,세종특별자치시,0,0,0,0,2020-03-05
302,대전광역시,4,215,4,0,2020-09-08
3947,강원도,27,3591,27,0,2021-07-19
38213,서울특별시,182,35044,177,5,2021-05-02
53,울산광역시,0,47,0,0,2020-06-17
36,강원도,0,20,0,0,2020-03-31
6983,대구광역시,5,6755,5,0,2020-08-25
5091,경기도,103,4488,98,5,2020-10-23
82,충청남도,1,0,1,0,2020-03-04
4,전라남도,0,1,0,0,2020-03-03
20,전라남도,0,18,0,0,2020-06-23
1017912,전라북도,578,0,578,0,2023-02-15
1006482,전라북도,1078,0,1078,0,2023-01-26
4079,울산광역시,22,3706,21,1,2021-08-28
3330,충청북도,2,3195,2,0,2021-07-06
8560,경상남도,125,7237,122,3,2021-08-13
243,강원도,2,220,0,2,2020-10-21
46,세종특별자치시,0,19,0,0,2020-04-13
81,제주특별자치도,1,63,0,1,2020-12-01
1089,울산광역시,1,968,1,0,2021-03-13
241575,세종특별자치시,28,0,28,0,2023-02-27
491,충청남도,0,446,0,0,2020-10-09
13377,대구광역시,90,12437,89,1,2021-08-27
5789,강원도,34,5396,33,1,2021-09-11
1324538,경상남도,8841,0,8805,36,2022-08-20
3815,전라남도,19,3562,19,0,2021-11-13
1827451,부산광역시,410,0,409,1,2023-03-21
7199,충청남도,81,6083,77,4,2021-09-03
2941,울산광역시,8,2793,8,0,2021-07-12
4043,강원도,54,3624,54,0,2021-07-21
5370,울산광역시,1,5266,1,0,2021-10-21
4590,인천광역시,20,4292,20,0,2021-03-09
7694,경상북도,24,7275,22,2,2021-09-18
2916,전라북도,20,2612,18,2,2021-08-07
40180,경기도,160,37370,157,3,2021-06-06
494,대전광역시,5,446,5,0,2020-11-30
895546,대전광역시,480,0,480,0,2023-03-21
1824953,부산광역시,540,0,540,0,2023-03-14
9437,강원도,109,8263,108,1,2021-12-07
76242,서울특별시,677,66391,673,4,2021-08-25
1679,광주광역시,44,1345,44,0,2021-01-28
4666,강원도,26,4183,26,0,2021-08-06
947116,충청북도,606,0,606,0,2023-02-02
1366,경상북도,0,1192,0,0,2020-05-07
25,충청북도,1,1,1,0,2020-03-09
8517,대구광역시,14,8158,12,2,2021-02-17
83,충청북도,1,73,1,0,2020-08-16
297,경상남도,0,287,0,0,2020-10-16
492,광주광역시,2,473,0,2,2020-09-27
678,전라남도,9,559,9,0,2021-01-20
1987,경상북도,25,1711,23,2,2020-12-20
463,충청남도,6,334,3,3,2020-09-18
981,충청북도,42,515,42,0,2020-12-25
117,경상남도,0,97,0,0,2020-04-28
1387,경상북도,0,1328,0,0,2020-06-28
4387,강원도,74,3801,74,0,2021-07-28
216,강원도,1,173,1,0,2020-09-13
133513,서울특별시,846,118566,839,7,2021-11-16
1327262,대구광역시,785,0,783,2,2023-02-14
1579,경상남도,19,1248,19,0,2021-01-10
5393,광주광역시,17,5274,14,3,2021-11-02
0,대전광역시,0,0,0,0,2020-02-10
0,전라남도,0,0,0,0,2020-01-26
71,충청북도,0,64,0,0,2020-07-18
7312,충청북도,41,6615,41,0,2021-10-17
657128,울산광역시,148,0,148,0,2023-03-16
4,제주특별자치도,0,1,0,0,2020-03-13
82,세종특별자치시,0,78,0,0,2020-11-05
32862,인천광역시,375,26331,371,4,2021-12-20
463,경기도,15,154,6,9,2020-03-30
1279332,인천광역시,6254,0,6155,99,2022-08-20
896,강원도,27,676,27,0,2020-12-19
17,전라북도,0,10,0,0,2020-04-25
28468,경기도,117,25953,112,5,2021-03-30
76805,경기도,613,67592,603,10,2021-09-10
6925,대구광역시,1,6708,0,1,2020-07-07
897006,강원도,211,0,211,0,2023-02-25
11613,충청남도,57,10673,57,0,2021-11-15
99,전라북도,2,69,0,2,2020-09-13
372225,제주특별자치도,488,0,487,1,2023-01-10
4352,경상북도,15,3979,15,0,2021-05-11
715,경상남도,16,470,15,1,2020-12-06
45,충청북도,0,26,0,0,2020-04-05
6981,경기도,117,5713,112,5,2020-11-27
6383,충청북도,39,5706,39,0,2021-10-01
63,전라북도,5,38,5,0,2020-08-21
1333,경상북도,3,965,3,0,2020-04-12
208,광주광역시,0,170,0,0,2020-08-08
111710,서울특별시,506,98509,503,3,2021-10-17
47,세종특별자치시,0,47,0,0,2020-06-17
10538,대구광역시,3,10157,3,0,2021-06-22
156,전라남도,0,47,0,0,2020-09-05
184,강원도,0,78,0,0,2020-08-29
7,전라북도,0,5,0,0,2020-03-16
3615,충청남도,4,3424,3,1,2021-06-08
5061,경상남도,5,4818,5,0,2021-06-17
772,전라남도,4,716,4,0,2021-02-12
143,충청남도,0,127,0,0,2020-05-03
612,서울특별시,2,220,0,2,2020-04-14
3155,광주광역시,14,2964,12,2,2021-07-19
868581,광주광역시,418,0,415,3,2023-01-16
2835,광주광역시,9,2716,9,0,2021-06-05
1410,경상북도,0,1342,0,0,2020-08-09
1364556,경상북도,1759,0,1756,3,2023-01-18
2138,경상남도,9,2037,9,0,2021-02-19
1175,대전광역시,2,1110,2,0,2021-02-20
220,강원도,1,203,1,0,2020-09-23
854,전라남도,5,758,5,0,2021-02-26
948123,충청북도,524,0,521,3,2023-02-04
7974,부산광역시,102,6814,99,3,2021-07-28
9,제주특별자치도,0,3,0,0,2020-04-03
2581,제주특별자치도,13,2238,12,1,2021-08-29
3084,전라남도,24,2837,24,0,2021-09-30
1330718,대구광역시,226,0,226,0,2023-02-20
1771883,인천광역시,465,0,464,1,2023-02-26
58,강원도,0,51,0,0,2020-06-09
19613,인천광역시,113,17676,112,1,2021-11-02
660,세종특별자치시,6,596,6,0,2021-07-21
2077,서울특별시,90,1571,89,1,2020-08-17
3860,전라남도,19,3595,19,0,2021-11-15
18629,서울특별시,387,10120,383,4,2020-12-30
1016,부산광역시,35,641,33,2,2020-12-07
1530,제주특별자치도,34,1365,34,0,2021-07-21
16473,충청남도,185,13747,184,1,2021-12-20
6487,인천광역시,17,6218,17,0,2021-06-17
1436,경기도,2,1225,1,1,2020-07-21
1637,충청북도,5,1500,4,1,2021-02-13
16250,경기도,303,11687,294,9,2021-01-07
1234,광주광역시,23,915,23,0,2021-01-05
2881,광주광역시,2,2819,1,1,2021-06-18
1288716,부산광역시,4677,0,4670,7,2022-08-16
8118,광주광역시,92,7349,91,1,2022-01-01
23249,대구광역시,125,21394,125,0,2022-01-01
18233,충청남도,138,15671,136,2,2022-01-01
12464,강원도,59,11209,59,0,2022-01-01
6981,울산광역시,58,6411,58,0,2022-01-02
12374,대전광역시,59,10653,54,5,2022-01-02
12523,강원도,59,11312,56,3,2022-01-02
6168,전라남도,42,5404,40,2,2022-01-02
11652,충청북도,50,10613,49,1,2022-01-02
37195,인천광역시,233,30964,231,2,2022-01-02
227879,서울특별시,1183,178481,1127,56,2022-01-02
23335,대구광역시,86,21544,83,3,2022-01-02
18334,충청남도,101,15900,98,3,2022-01-02
11699,충청북도,47,10759,45,2,2022-01-03
23433,대구광역시,98,21643,97,1,2022-01-03
4708,제주특별자치도,28,4486,27,1,2022-01-03
2180,세종특별자치시,10,2011,9,1,2022-01-03
6203,전라남도,35,5519,33,2,2022-01-03
25676,부산광역시,173,21852,166,7,2022-01-03
15574,경상북도,49,13854,47,2,2022-01-03
37382,인천광역시,187,32806,177,10,2022-01-03
12423,대전광역시,49,10677,46,3,2022-01-03
7019,울산광역시,38,6453,38,0,2022-01-03
9818,전라북도,86,8498,83,3,2022-01-03
7053,울산광역시,34,6517,33,1,2022-01-04
2191,세종특별자치시,11,2035,11,0,2022-01-04
8347,광주광역시,61,7529,59,2,2022-01-04
12640,강원도,63,11599,62,1,2022-01-04
25821,부산광역시,145,22216,143,2,2022-01-04
23517,대구광역시,84,21794,79,5,2022-01-04
23629,대구광역시,112,21948,108,4,2022-01-05
231213,서울특별시,1412,183420,1346,66,2022-01-05
6309,전라남도,60,5614,60,0,2022-01-05
26076,부산광역시,255,22582,248,7,2022-01-05
4769,제주특별자치도,43,4531,43,0,2022-01-05
2208,세종특별자치시,17,2049,17,0,2022-01-05
15733,경상북도,97,14158,97,0,2022-01-05
26304,부산광역시,228,22975,222,6,2022-01-06
232419,서울특별시,1208,184918,1150,58,2022-01-06
11873,충청북도,45,11011,45,0,2022-01-06
18781,충청남도,79,16500,77,2,2022-01-06
7131,울산광역시,30,6604,28,2,2022-01-06
193888,경기도,1526,156060,1496,30,2022-01-06
10078,전라북도,71,8821,71,0,2022-01-06
8513,광주광역시,91,7593,91,0,2022-01-06
11963,충청북도,90,11063,88,2,2022-01-07
12578,대전광역시,29,11051,28,1,2022-01-07
21548,경상남도,102,19689,99,3,2022-01-07
6492,전라남도,124,5695,120,4,2022-01-07
4798,제주특별자치도,10,4549,8,2,2022-01-07
12856,강원도,90,11916,88,2,2022-01-07
38491,인천광역시,203,33916,193,10,2022-01-08
196357,경기도,1208,165430,1168,40,2022-01-08
2252,세종특별자치시,12,2091,11,1,2022-01-08
12625,대전광역시,47,11218,42,5,2022-01-08
21648,경상남도,101,19922,96,5,2022-01-08
6588,전라남도,96,5742,93,3,2022-01-08
19104,충청남도,111,16826,106,5,2022-01-09
197471,경기도,1114,165637,1081,33,2022-01-09
26850,부산광역시,158,23798,151,7,2022-01-09
6700,전라남도,112,5771,111,1,2022-01-09
38676,인천광역시,185,34136,172,13,2022-01-09
8914,광주광역시,133,8040,131,2,2022-01-10
19202,충청남도,101,16947,90,11,2022-01-10
27015,부산광역시,165,24067,158,7,2022-01-10
7253,울산광역시,23,6782,20,3,2022-01-10
24148,대구광역시,94,22561,89,5,2022-01-10
12080,충청북도,30,11286,27,3,2022-01-10
12698,대전광역시,33,11271,30,3,2022-01-10
2278,세종특별자치시,13,2129,12,1,2022-01-10
38801,인천광역시,125,34308,115,10,2022-01-10
6786,전라남도,86,5771,83,3,2022-01-10
21826,경상남도,80,20316,77,3,2022-01-10
16257,경상북도,60,14837,58,2,2022-01-11
9090,광주광역시,176,8094,175,1,2022-01-11
27130,부산광역시,115,24294,108,7,2022-01-11
12741,대전광역시,43,11530,34,9,2022-01-11
6874,전라남도,88,5846,87,1,2022-01-11
24311,대구광역시,93,22788,91,2,2022-01-12
4851,제주특별자치도,5,4663,4,1,2022-01-12
2308,세종특별자치시,14,2163,14,0,2022-01-12
39216,인천광역시,262,34707,243,19,2022-01-12
27294,부산광역시,164,24511,156,8,2022-01-12
9436,광주광역시,188,8221,182,6,2022-01-13
7329,울산광역시,27,6928,26,1,2022-01-13
10623,전라북도,106,9632,106,0,2022-01-13
12899,대전광역시,68,11636,63,5,2022-01-13
202762,경기도,1535,166404,1444,91,2022-01-13
13368,강원도,89,12342,82,7,2022-01-13
239014,서울특별시,978,194346,858,120,2022-01-13
19553,충청남도,131,17151,126,5,2022-01-13
13512,강원도,144,12372,139,5,2022-01-14
39722,인천광역시,266,34965,242,24,2022-01-14
19659,충청남도,106,17186,99,7,2022-01-14
16526,경상북도,93,15101,88,5,2022-01-14
24526,대구광역시,90,22976,77,13,2022-01-14
7307,전라남도,133,5884,132,1,2022-01-14
7369,울산광역시,40,6967,34,6,2022-01-14
12965,대전광역시,66,11666,64,2,2022-01-14
4877,제주특별자치도,13,4754,10,3,2022-01-15
13591,강원도,79,12372,75,4,2022-01-15
2338,세종특별자치시,15,2201,15,0,2022-01-15
7386,울산광역시,17,7009,14,3,2022-01-15
39970,인천광역시,248,35151,221,27,2022-01-15
240862,서울특별시,912,196739,823,89,2022-01-15
16729,경상북도,108,15234,102,6,2022-01-16
241784,서울특별시,925,197525,826,99,2022-01-16
13072,대전광역시,54,11717,47,7,2022-01-16
208027,경기도,1586,166976,1511,75,2022-01-16
13665,강원도,74,12487,69,5,2022-01-16
10049,광주광역시,183,8382,173,10,2022-01-16
10970,전라북도,123,9946,112,11,2022-01-16
19893,충청남도,114,17220,105,9,2022-01-16
40230,인천광역시,260,35356,235,25,2022-01-16
24808,대구광역시,157,23158,147,10,2022-01-16
11094,전라북도,124,10024,114,10,2022-01-17
7424,울산광역시,19,7080,17,2,2022-01-17
22636,경상남도,119,21176,106,13,2022-01-17
4897,제주특별자치도,12,4783,12,0,2022-01-17
242574,서울특별시,790,197998,711,79,2022-01-17
27988,부산광역시,117,25632,109,8,2022-01-17
19997,충청남도,104,17328,93,11,2022-01-17
12497,충청북도,42,11725,38,4,2022-01-17
16824,경상북도,95,15281,87,8,2022-01-17
7796,전라남도,166,5885,161,5,2022-01-17
10291,광주광역시,242,8523,237,5,2022-01-17
210984,경기도,1530,167373,1470,60,2022-01-18
4900,제주특별자치도,3,4792,2,1,2022-01-18
12555,충청북도,59,11766,55,4,2022-01-18
20142,충청남도,145,17373,140,5,2022-01-18
11245,전라북도,151,10086,147,4,2022-01-18
13838,강원도,94,12657,94,0,2022-01-18
243337,서울특별시,763,198148,684,79,2022-01-18
25155,대구광역시,171,23380,162,9,2022-01-18
11388,전라북도,143,10156,134,9,2022-01-19
17132,경상북도,170,15280,151,19,2022-01-19
13379,대전광역시,118,11860,109,9,2022-01-19
25368,대구광역시,213,23498,197,16,2022-01-19
28292,부산광역시,190,25989,178,12,2022-01-19
4913,제주특별자치도,13,4804,8,5,2022-01-19
12812,충청북도,176,11844,174,2,2022-01-20
23203,경상남도,224,21470,218,6,2022-01-20
41467,인천광역시,418,35746,407,11,2022-01-20
28495,부산광역시,203,26173,193,10,2022-01-20
13476,대전광역시,97,11895,94,3,2022-01-20
245925,서울특별시,1362,199829,1292,70,2022-01-20
8249,전라남도,160,5885,157,3,2022-01-20
14258,강원도,161,12861,136,25,2022-01-21
20735,충청남도,193,17605,183,10,2022-01-21
218009,경기도,2431,168164,2349,82,2022-01-21
11691,전라북도,165,10318,159,6,2022-01-21
41919,인천광역시,452,36047,438,14,2022-01-21
23391,경상남도,188,21571,178,10,2022-01-21
2440,세종특별자치시,17,2286,17,0,2022-01-21
11297,광주광역시,242,8787,237,5,2022-01-21
13706,대전광역시,119,11979,118,1,2022-01-22
13048,충청북도,150,11961,143,7,2022-01-22
20935,충청남도,200,17605,191,9,2022-01-22
11862,전라북도,171,10379,167,4,2022-01-22
8602,전라남도,154,5885,152,2,2022-01-22
7708,울산광역시,51,7194,50,1,2022-01-22
26564,대구광역시,444,23748,442,2,2022-01-22
223148,경기도,2713,168736,2667,46,2022-01-23
18014,경상북도,215,15526,207,8,2022-01-23
250758,서울특별시,1694,205470,1634,60,2022-01-23
8798,전라남도,196,5885,191,5,2022-01-23
14446,강원도,89,13055,79,10,2022-01-23
4982,제주특별자치도,27,4845,23,4,2022-01-23
21142,충청남도,207,17830,197,10,2022-01-23
43098,인천광역시,610,36458,589,21,2022-01-23
18248,경상북도,234,15526,213,21,2022-01-24
14546,강원도,100,13129,96,4,2022-01-24
24070,경상남도,234,21895,220,14,2022-01-24
13305,충청북도,147,12075,141,6,2022-01-24
225590,경기도,2442,168956,2391,51,2022-01-24
5002,제주특별자치도,20,4851,15,5,2022-01-24
21407,충청남도,265,17990,240,25,2022-01-24
27501,대구광역시,479,23951,463,16,2022-01-24
2509,세종특별자치시,33,2315,31,2,2022-01-24
252437,서울특별시,1679,205997,1626,53,2022-01-24
254160,서울특별시,1724,206926,1674,50,2022-01-25
13429,충청북도,124,12127,122,2,2022-01-25
5034,제주특별자치도,32,4864,30,2,2022-01-25
9195,전라남도,191,5885,187,4,2022-01-25
5087,제주특별자치도,53,4872,51,2,2022-01-26
22135,충청남도,417,18222,403,14,2022-01-26
18974,경상북도,445,15560,438,7,2022-01-26
28662,대구광역시,672,24256,664,8,2022-01-26
8117,울산광역시,148,7265,142,6,2022-01-26
45229,인천광역시,879,37051,860,19,2022-01-26
13205,광주광역시,343,9689,337,6,2022-01-27
9775,전라남도,294,5886,289,5,2022-01-27
260757,서울특별시,3429,209615,3385,44,2022-01-27
2731,세종특별자치시,76,2358,76,0,2022-01-27
15063,강원도,189,13421,187,2,2022-01-27
8265,울산광역시,148,7371,146,2,2022-01-27
46258,인천광역시,1029,37250,1010,19,2022-01-27
29430,대구광역시,770,24552,764,6,2022-01-27
25616,경상남도,660,22313,654,6,2022-01-27
13970,충청북도,294,12250,287,7,2022-01-27
22574,충청남도,439,18222,431,8,2022-01-27
13627,광주광역시,422,9924,420,2,2022-01-28
10102,전라남도,327,5886,323,4,2022-01-28
47499,인천광역시,1244,37250,1228,16,2022-01-28
242663,경기도,5175,170329,5143,32,2022-01-28
15275,강원도,212,13581,211,1,2022-01-28
20001,경상북도,538,15717,529,9,2022-01-28
8423,울산광역시,158,7396,156,2,2022-01-28
15401,대전광역시,370,12208,367,3,2022-01-28
5203,제주특별자치도,44,4899,44,0,2022-01-28
20591,경상북도,590,15719,578,12,2022-01-29
8623,울산광역시,200,7432,200,0,2022-01-29
31177,대구광역시,881,25066,875,6,2022-01-29
15830,대전광역시,429,12239,425,4,2022-01-29
14579,충청북도,310,12522,309,1,2022-01-29
14049,광주광역시,422,10168,417,5,2022-01-29
32813,부산광역시,808,27733,804,4,2022-01-29
5279,제주특별자치도,76,4921,74,2,2022-01-29
248292,경기도,5629,170695,5588,41,2022-01-29
49114,인천광역시,1615,38039,1599,16,2022-01-29
15482,강원도,207,13770,205,2,2022-01-29
10416,전라남도,314,5886,310,4,2022-01-29
33664,부산광역시,851,27923,841,10,2022-01-30
24303,충청남도,676,18337,668,8,2022-01-30
8835,울산광역시,212,7472,202,10,2022-01-30
5348,제주특별자치도,69,4934,67,2,2022-01-30
14412,전라북도,437,11476,432,5,2022-01-30
27545,경상남도,629,22969,617,12,2022-01-30
15703,강원도,221,13860,215,6,2022-01-30
21187,경상북도,597,15894,589,8,2022-01-30
16725,대전광역시,446,12613,444,2,2022-01-31
15286,충청북도,356,12883,351,5,2022-01-31
21774,경상북도,587,15894,583,4,2022-01-31
24972,충청남도,676,18337,666,10,2022-01-31
15980,강원도,277,14019,272,5,2022-01-31
259108,경기도,5105,171412,5064,41,2022-01-31
277325,서울특별시,4193,213919,4148,45,2022-01-31
15008,광주광역시,482,10364,476,6,2022-01-31
33063,대구광역시,981,25631,973,8,2022-01-31
2986,세종특별자치시,78,2443,78,0,2022-01-31
9037,울산광역시,202,7542,202,0,2022-01-31
5422,제주특별자치도,74,4951,71,3,2022-01-31
11440,전라남도,411,6589,402,9,2022-02-01
5508,제주특별자치도,86,4963,86,0,2022-02-01
35414,부산광역시,980,28360,972,8,2022-02-01
16234,강원도,254,14019,253,1,2022-02-01
15508,광주광역시,500,10521,493,7,2022-02-01
29156,경상남도,858,23379,845,13,2022-02-01
53037,인천광역시,1381,39349,1366,15,2022-02-01
264645,경기도,5537,171703,5509,28,2022-02-01
17187,대전광역시,462,12684,460,2,2022-02-01
30057,경상남도,901,23557,893,8,2022-02-02
17668,대전광역시,481,12749,479,2,2022-02-02
26588,충청남도,889,18337,881,8,2022-02-02
11908,전라남도,468,6589,464,4,2022-02-02
5630,제주특별자치도,122,4983,120,2,2022-02-02
16154,충청북도,459,13199,455,4,2022-02-02
23170,경상북도,777,15895,771,6,2022-02-02
35177,대구광역시,1147,27062,1141,6,2022-02-02
24105,경상북도,935,15895,929,6,2022-02-03
16724,충청북도,570,13396,568,2,2022-02-03
16820,광주광역시,694,10768,691,3,2022-02-03
12362,전라남도,454,6589,452,2,2022-02-03
277252,경기도,6557,172340,6532,25,2022-02-03
5799,제주특별자치도,169,5073,168,1,2022-02-03
17057,강원도,469,14328,467,2,2022-02-03
17352,충청북도,628,13665,628,0,2022-02-04
32031,경상남도,1064,23888,1056,8,2022-02-04
28577,충청남도,1072,18338,1067,5,2022-02-04
6011,제주특별자치도,212,5116,207,5,2022-02-04
3920,세종특별자치시,296,2688,293,3,2022-02-05
18893,광주광역시,1244,11065,1232,12,2022-02-05
26738,경상북도,1489,15930,1485,4,2022-02-05
60254,인천광역시,2500,42390,2494,6,2022-02-05
33514,경상남도,1483,24432,1480,3,2022-02-05
29737,충청남도,1160,18389,1155,5,2022-02-05
6259,제주특별자치도,248,5167,247,1,2022-02-05
306879,경기도,11952,172955,11924,28,2022-02-06
6544,제주특별자치도,285,5228,285,0,2022-02-06
21212,대전광역시,1190,13096,1189,1,2022-02-06
41756,대구광역시,1971,30016,1967,4,2022-02-06
15167,전라남도,1192,6590,1190,2,2022-02-06
11999,울산광역시,593,8152,592,1,2022-02-07
6913,제주특별자치도,369,5288,368,1,2022-02-07
19177,강원도,740,19916,738,2,2022-02-07
19966,충청북도,885,14248,884,1,2022-02-07
21756,전라북도,1271,13377,1269,2,2022-02-07
16300,전라남도,1133,16300,1129,4,2022-02-07
320343,서울특별시,6888,224002,6873,15,2022-02-07
21288,광주광역시,1209,21288,1205,4,2022-02-07
21756,전라북도,1271,21756,1269,2,2022-02-07
62492,인천광역시,2376,64867,2366,10,2022-02-07
4189,세종특별자치시,262,4451,261,1,2022-02-07
22181,대전광역시,969,22181,968,1,2022-02-07
36949,경상남도,1672,36949,1664,8,2022-02-07
4451,세종특별자치시,262,2804,261,1,2022-02-07
20079,광주광역시,1209,21288,1205,4,2022-02-07
11999,울산광역시,593,11999,592,1,2022-02-07
35277,경상남도,1672,36949,1664,8,2022-02-07
15167,전라남도,1133,16300,1129,4,2022-02-07
19081,충청북도,885,19966,884,1,2022-02-07
32736,충청남도,1473,18824,1467,6,2022-02-07
31263,충청남도,1473,32736,1467,6,2022-02-07
36949,경상남도,1672,25659,1664,8,2022-02-07
43726,대구광역시,1971,43726,1967,4,2022-02-07
43791,부산광역시,1927,45718,1916,11,2022-02-07
45718,부산광역시,1927,45718,1916,11,2022-02-07
19966,충청북도,885,19966,884,1,2022-02-07
41756,대구광역시,1971,43726,1967,4,2022-02-07
64867,인천광역시,2376,42802,2366,10,2022-02-07
34138,충청남도,1402,18892,1401,1,2022-02-08
12500,울산광역시,501,8438,501,0,2022-02-08
20765,충청북도,799,14756,796,3,2022-02-08
23124,대전광역시,943,13423,940,3,2022-02-08
47639,부산광역시,1921,31682,1918,3,2022-02-08
7295,제주특별자치도,382,5361,382,0,2022-02-08
22982,전라북도,1226,13933,1225,1,2022-02-08
38851,경상남도,1902,26330,1894,8,2022-02-08
67849,인천광역시,2982,42802,2976,6,2022-02-08
24032,광주광역시,1503,12079,1495,8,2022-02-09
342473,경기도,13651,212099,13641,10,2022-02-09
35906,충청남도,1768,19354,1761,7,2022-02-09
13291,울산광역시,791,8589,789,2,2022-02-09
22142,충청북도,1377,15094,1375,2,2022-02-09
71780,인천광역시,3931,44522,3912,19,2022-02-09
24545,전라북도,1564,14468,1562,2,2022-02-09
337930,서울특별시,11682,233660,11630,52,2022-02-09
50674,부산광역시,3035,32181,3034,1,2022-02-09
19938,전라남도,1495,6927,1492,3,2022-02-10
50259,대구광역시,2329,33713,2328,1,2022-02-10
43138,경상남도,2341,27912,2341,0,2022-02-10
37622,충청남도,1716,19516,1711,5,2022-02-10
349805,서울특별시,11875,238229,11873,2,2022-02-10
14818,울산광역시,795,9492,795,0,2022-02-11
361336,서울특별시,11531,240433,11528,3,2022-02-11
21179,전라남도,1241,6926,1234,7,2022-02-11
24380,충청북도,1156,16868,1156,0,2022-02-11
27823,전라북도,1507,15435,1504,3,2022-02-11
22394,전라남도,1215,6926,1210,5,2022-02-12
55126,대구광역시,2370,37051,2370,0,2022-02-12
15544,울산광역시,726,9997,726,0,2022-02-12
24610,강원도,960,17814,957,3,2022-02-12
39251,경상북도,1831,18198,1827,4,2022-02-12
84589,인천광역시,5068,48706,5059,9,2022-02-12
25537,충청북도,1157,18013,1154,3,2022-02-12
9133,제주특별자치도,503,6299,503,0,2022-02-12
47026,경상남도,1699,33231,1696,3,2022-02-12
5913,세종특별자치시,326,3755,323,3,2022-02-12
41306,경상북도,2055,18198,2046,9,2022-02-13
386358,서울특별시,11824,246908,11777,47,2022-02-13
43771,충청남도,2375,20080,2374,1,2022-02-13
49691,경상남도,2666,33231,2663,3,2022-02-13
31011,전라북도,1642,16972,1637,5,2022-02-13
9687,제주특별자치도,554,6624,552,2,2022-02-13
30133,대전광역시,1495,14060,1493,2,2022-02-13
89064,인천광역시,4475,48939,4469,6,2022-02-13
57696,대구광역시,2573,39235,2573,0,2022-02-13
46269,충청남도,2498,20131,2493,5,2022-02-14
66329,부산광역시,3520,33934,3520,0,2022-02-14
26687,강원도,1092,18699,1087,5,2022-02-14
34181,전라북도,1579,17804,1579,0,2022-02-15
27866,강원도,1179,19395,1174,5,2022-02-15
62664,대구광역시,2362,42850,2362,0,2022-02-15
29737,충청북도,1327,20046,1322,5,2022-02-15
97547,인천광역시,4906,50327,4904,2,2022-02-15
17801,울산광역시,776,11613,776,0,2022-02-15
26140,전라남도,1301,6928,1299,2,2022-02-15
48488,충청남도,2219,20485,2218,1,2022-02-15
69419,부산광역시,3090,35675,3080,10,2022-02-15
7065,세종특별자치시,415,4550,415,0,2022-02-15
47853,경상북도,2869,18685,2863,6,2022-02-16
51491,충청남도,3003,20608,2991,12,2022-02-16
429289,서울특별시,18879,252743,18834,45,2022-02-16
103367,인천광역시,5822,52656,5817,5,2022-02-16
59716,경상남도,4450,38854,4445,5,2022-02-16
7761,세종특별자치시,696,4753,694,2,2022-02-16
36743,전라북도,2562,21543,2555,7,2022-02-16
82121,부산광역시,6219,40549,6216,3,2022-02-17
54506,충청남도,3015,20718,3013,2,2022-02-17
448977,서울특별시,19689,255877,19678,11,2022-02-17
29963,전라남도,1893,6928,1892,1,2022-02-17
38613,대전광역시,2702,15150,2702,0,2022-02-17
110600,인천광역시,7238,53285,7235,3,2022-02-17
64197,경상남도,4481,40504,4477,4,2022-02-17
8417,세종특별자치시,656,5052,656,0,2022-02-17
34107,충청북도,2169,22156,2166,3,2022-02-17
500738,경기도,28447,229595,28438,9,2022-02-17
23198,울산광역시,1947,13840,1947,0,2022-02-18
68819,경상남도,4622,40553,4609,13,2022-02-18
13665,제주특별자치도,1114,8470,1114,0,2022-02-18
40709,광주광역시,2669,13440,2665,4,2022-02-18
31873,전라남도,1911,6930,1908,3,2022-02-18
57450,충청남도,2944,21040,2939,5,2022-02-18
474628,서울특별시,25651,258071,25626,25,2022-02-18
41826,전라북도,2510,22328,2503,7,2022-02-18
75591,대구광역시,4538,48896,4538,0,2022-02-18
35110,강원도,1799,22008,1798,1,2022-02-19
44318,전라북도,2492,24066,2486,6,2022-02-19
567891,경기도,30642,229861,30641,1,2022-02-19
39055,충청북도,2394,24398,2392,2,2022-02-19
73236,경상남도,4418,40610,4414,4,2022-02-19
14871,제주특별자치도,1206,9556,1205,1,2022-02-19
57223,경상북도,3186,19096,3180,6,2022-02-19
9796,세종특별자치시,677,5509,676,1,2022-02-19
102180,부산광역시,6946,45041,6940,6,2022-02-20
134948,인천광역시,9191,63656,9188,3,2022-02-20
60572,경상북도,3349,19098,3342,7,2022-02-20
35837,전라남도,2064,6931,2060,4,2022-02-20
47109,전라북도,2791,25939,2778,13,2022-02-20
64875,충청남도,3348,21541,3343,5,2022-02-20
78329,경상남도,5093,40611,5087,6,2022-02-20
519923,서울특별시,22102,267644,22100,2,2022-02-20
109720,부산광역시,7541,45045,7540,1,2022-02-21
539938,서울특별시,20018,269795,19957,61,2022-02-21
625998,경기도,26779,230011,26777,2,2022-02-21
88678,대구광역시,4160,56953,4160,0,2022-02-21
48700,광주광역시,2589,13565,2584,5,2022-02-21
37907,전라남도,2070,6931,2070,0,2022-02-21
63822,경상북도,3250,19098,3246,4,2022-02-21
115860,부산광역시,6140,45169,6137,3,2022-02-22
40015,전라남도,2109,6933,2106,3,2022-02-22
51947,광주광역시,3247,13667,3239,8,2022-02-22
53491,대전광역시,2849,16333,2848,1,2022-02-22
66949,경상북도,3127,21647,3114,13,2022-02-22
52300,전라북도,2463,28868,2456,7,2022-02-22
561744,서울특별시,21807,274931,21769,38,2022-02-22
18482,제주특별자치도,1301,11681,1301,0,2022-02-22
71505,충청남도,3337,22372,3333,4,2022-02-22
88211,경상남도,4839,49583,4829,10,2022-02-22
56172,광주광역시,4225,13751,4221,4,2022-02-23
71945,경상북도,4996,23516,4992,4,2022-02-23
12827,세종특별자치시,1079,7324,1079,0,2022-02-23
99142,대구광역시,6306,63295,6306,0,2022-02-23
43098,전라남도,3083,6933,3081,2,2022-02-23
33929,울산광역시,3447,19815,3447,0,2022-02-23
76343,충청남도,4838,23480,4832,6,2022-02-23
77149,경상북도,5204,25510,5199,5,2022-02-24
60307,광주광역시,4136,13883,4128,8,2022-02-24
760412,경기도,51320,230615,51317,3,2022-02-24
140512,부산광역시,11836,45895,11835,1,2022-02-24
47494,강원도,3121,26037,3120,1,2022-02-24
49997,전라남도,3533,6935,3529,4,2022-02-25
187855,인천광역시,12847,79664,12843,4,2022-02-25
82542,경상북도,5393,28619,5387,6,2022-02-25
23806,제주특별자치도,2062,14677,2062,0,2022-02-25
14973,세종특별자치시,1064,8597,1064,0,2022-02-25
66479,대전광역시,4406,20739,4406,0,2022-02-25
50923,강원도,3429,27098,3426,3,2022-02-25
808494,경기도,48082,230784,48080,2,2022-02-25
166271,부산광역시,13023,46309,13022,1,2022-02-26
712822,서울특별시,36829,292160,36773,56,2022-02-26
199968,인천광역시,12113,81655,12113,0,2022-02-26
91798,충청남도,5284,26634,5283,1,2022-02-26
43818,울산광역시,3128,25453,3128,0,2022-02-26
54187,강원도,3264,28233,3258,6,2022-02-26
25723,제주특별자치도,1917,15597,1916,1,2022-02-26
69794,광주광역시,4883,14056,4866,17,2022-02-26
74792,대전광역시,4048,24926,4046,2,2022-02-27
56847,전라남도,3413,6939,3409,4,2022-02-27
903445,경기도,46801,230936,46799,2,2022-02-27
65455,충청북도,4092,36904,4085,7,2022-02-27
748173,서울특별시,35351,292160,35286,65,2022-02-27
93230,경상북도,5383,31730,5377,6,2022-02-27
179948,부산광역시,13677,46309,13674,3,2022-02-27
211101,인천광역시,11133,81655,11129,4,2022-02-27
17726,세종특별자치시,834,9676,834,0,2022-02-28
221842,인천광역시,10741,81655,10740,1,2022-02-28
60167,전라남도,3320,6939,3318,2,2022-02-28
78475,대전광역시,3683,24926,3683,0,2022-02-28
78234,광주광역시,4167,14056,4153,14,2022-02-28
140653,경상남도,8413,65791,8398,15,2022-02-28
98170,경상북도,4940,31730,4935,5,2022-02-28
192559,부산광역시,12617,46309,12615,2,2022-02-28
230798,인천광역시,8956,85945,8956,0,2022-03-01
148684,경상남도,8031,84965,8018,13,2022-03-01
102838,경상북도,4668,39122,4665,3,2022-03-01
804029,서울특별시,27885,303589,27885,0,2022-03-01
80834,전라북도,3938,39182,3937,1,2022-03-01
979916,경기도,39213,231382,39211,2,2022-03-01
31969,제주특별자치도,2273,19567,2273,0,2022-03-01
136938,대구광역시,5382,87703,5382,0,2022-03-01
203763,부산광역시,11204,66490,11202,2,2022-03-01
144053,대구광역시,7117,87703,7117,0,2022-03-02
1048539,경기도,68623,231382,68622,1,2022-03-02
77581,충청북도,5574,44678,5569,5,2022-03-02
109807,경상북도,6969,39122,6961,8,2022-03-02
219867,부산광역시,16104,66490,16104,0,2022-03-02
69333,강원도,4971,30790,4966,5,2022-03-02
850962,서울특별시,46933,303589,46932,1,2022-03-02
88299,광주광역시,5259,14258,5256,3,2022-03-02
161884,경상남도,13201,84965,13196,5,2022-03-02
92508,대전광역시,5067,32355,5067,0,2022-03-03
82410,충청북도,4829,52433,4820,9,2022-03-03
21036,세종특별자치시,1022,12999,1022,0,2022-03-03
152133,대구광역시,8080,99303,8080,0,2022-03-03
173828,경상남도,11944,92938,11942,2,2022-03-03
92532,전라북도,5285,39191,5280,5,2022-03-03
894637,서울특별시,43675,314250,43675,0,2022-03-03
95297,광주광역시,6998,14414,6994,4,2022-03-03
61072,울산광역시,3389,38526,3389,0,2022-03-03
1100482,경기도,51943,232460,51941,2,2022-03-03
121252,충청남도,6639,29877,6639,0,2022-03-03
234126,부산광역시,14259,67015,14258,1,2022-03-03
98466,대전광역시,5958,32410,5958,0,2022-03-04
257324,부산광역시,23202,67015,23200,2,2022-03-04
124722,경상북도,8382,44772,8373,9,2022-03-04
275547,인천광역시,16683,93876,16681,2,2022-03-04
40869,제주특별자치도,3399,25650,3399,0,2022-03-04
80102,전라남도,6412,6951,6409,3,2022-03-04
189827,경상남도,15999,92936,15991,8,2022-03-04
66885,울산광역시,5813,38526,5813,0,2022-03-04
161626,대구광역시,9494,105742,9491,3,2022-03-04
1007099,서울특별시,53193,327273,53191,2,2022-03-05
171189,대구광역시,9563,111576,9563,0,2022-03-05
96096,충청북도,6948,59971,6944,4,2022-03-05
72466,울산광역시,5581,42008,5581,0,2022-03-05
132943,경상북도,8221,47936,8219,2,2022-03-05
1247452,경기도,70244,232836,70243,1,2022-03-05
137524,충청남도,8010,32214,8010,0,2022-03-05
279146,부산광역시,21822,67502,21820,2,2022-03-05
91158,강원도,5709,34811,5702,7,2022-03-06
141139,경상북도,8199,47936,8191,8,2022-03-06
305351,부산광역시,26205,67502,26204,1,2022-03-06
219407,경상남도,14425,92938,14417,8,2022-03-06
77481,울산광역시,5015,42008,5015,0,2022-03-06
118974,전라북도,6065,57751,6063,2,2022-03-07
187874,대구광역시,7789,111576,7789,0,2022-03-07
324568,인천광역시,15324,93877,15323,1,2022-03-07
232857,경상남도,13450,92938,13441,9,2022-03-07
1365390,경기도,51106,232836,51097,9,2022-03-07
331807,부산광역시,26456,67502,26456,0,2022-03-07
107233,충청북도,4904,59971,4900,4,2022-03-07
116107,대전광역시,5760,32428,5760,0,2022-03-07
337172,인천광역시,12606,101606,12603,3,2022-03-08
158582,충청남도,6997,32587,6997,0,2022-03-08
103526,전라남도,6014,6954,6008,6,2022-03-08
85954,울산광역시,4560,54071,4560,0,2022-03-08
102067,강원도,5460,37462,5458,2,2022-03-08
27967,세종특별자치시,1349,19064,1349,0,2022-03-08
54129,제주특별자치도,3054,33336,3054,0,2022-03-08
1418120,경기도,52730,233242,52729,1,2022-03-08
125238,전라북도,6264,77310,6260,4,2022-03-08
351170,부산광역시,19363,68213,19361,2,2022-03-08
156027,경상북도,7374,54568,7368,6,2022-03-08
134917,전라북도,9679,82010,9677,2,2022-03-09
268893,경상남도,22006,135970,22001,5,2022-03-09
30181,세종특별자치시,2214,19962,2214,0,2022-03-09
57987,제주특별자치도,3858,36235,3858,0,2022-03-09
208359,대구광역시,12899,136100,12899,0,2022-03-09
1207803,서울특별시,74222,353601,74222,0,2022-03-09
122109,충청북도,9149,72084,9145,4,2022-03-09
356000,인천광역시,18828,103745,18823,5,2022-03-09
413900,부산광역시,31578,68472,31568,10,2022-03-10
130871,충청북도,8765,72084,8765,0,2022-03-10
101325,울산광역시,8789,57385,8789,0,2022-03-10
119947,전라남도,8470,6956,8467,3,2022-03-10
288305,경상남도,19412,135970,19410,2,2022-03-10
137576,대전광역시,7884,34668,7884,0,2022-03-10
144992,전라북도,10075,82010,10072,3,2022-03-10
142798,광주광역시,6300,14727,6300,0,2022-03-10
377975,인천광역시,21975,103745,21974,1,2022-03-10
144788,대전광역시,7212,34668,7212,0,2022-03-11
1331263,서울특별시,56603,353601,56600,3,2022-03-11
230261,대구광역시,10307,151483,10307,0,2022-03-11
151646,광주광역시,8848,14807,8836,12,2022-03-11
436820,부산광역시,22920,68841,22917,3,2022-03-11
138784,충청북도,7914,72084,7910,4,2022-03-11
106586,울산광역시,5261,57385,5261,0,2022-03-11
1675373,경기도,72427,233813,72420,7,2022-03-11
395433,인천광역시,17458,115210,17457,1,2022-03-11
230261,대구광역시,10307,136100,10307,0,2022-03-11
138784,충청북도,7914,82735,7910,4,2022-03-11
126407,강원도,7482,37461,7480,2,2022-03-11
204159,경상북도,13566,65806,13558,8,2022-03-12
419170,인천광역시,23738,118912,23735,3,2022-03-12
148660,충청북도,9876,88549,9871,5,2022-03-12
160600,광주광역시,8954,14836,8948,6,2022-03-12
36477,세종특별자치시,2512,24464,2512,0,2022-03-12
72390,제주특별자치도,5191,47281,5191,0,2022-03-12
334012,경상남도,24282,176950,24279,3,2022-03-12
468786,부산광역시,31967,110869,31967,0,2022-03-12
135841,강원도,9434,50728,9433,1,2022-03-12
1411694,서울특별시,80437,374439,80437,0,2022-03-12
1479502,서울특별시,67814,374439,67814,0,2022-03-13
1874781,경기도,91470,233939,91469,1,2022-03-13
148692,전라남도,9546,6959,9544,2,2022-03-13
217932,경상북도,13773,65806,13765,8,2022-03-13
256368,대구광역시,12696,159954,12696,0,2022-03-13
360110,경상남도,26098,176950,26096,2,2022-03-13
176118,전라북도,11441,94870,11441,0,2022-03-13
502229,부산광역시,33443,110869,33442,1,2022-03-13
145222,강원도,9381,50728,9380,1,2022-03-13
167793,광주광역시,7193,14836,7191,2,2022-03-13
38802,세종특별자치시,2325,24464,2325,0,2022-03-13
158654,충청북도,9997,88549,9997,0,2022-03-13
227583,충청남도,12329,50343,12329,0,2022-03-14
529987,부산광역시,27759,110869,27756,3,2022-03-14
1952202,경기도,77421,233939,77420,1,2022-03-14
159623,전라남도,10933,6959,10933,0,2022-03-14
166980,충청북도,8326,88549,8324,2,2022-03-14
130189,울산광역시,5336,73212,5336,0,2022-03-14
176132,광주광역시,8339,14836,8334,5,2022-03-14
243870,충청남도,16287,64009,16287,0,2022-03-15
2055186,경기도,102984,233966,102983,1,2022-03-15
43455,세종특별자치시,2514,28684,2514,0,2022-03-15
177907,충청북도,10928,104863,10923,5,2022-03-15
178552,대전광역시,8309,59088,8309,0,2022-03-15
187305,광주광역시,11173,14961,11167,6,2022-03-15
87320,제주특별자치도,3900,53369,3900,0,2022-03-15
198550,전라북도,11259,94871,11257,2,2022-03-15
478090,인천광역시,20445,131958,20444,1,2022-03-15
407816,경상남도,23941,219791,23939,2,2022-03-15
283124,대구광역시,14350,182274,14350,0,2022-03-15
556137,부산광역시,26151,111238,26149,2,2022-03-15
191661,충청북도,13755,113351,13751,4,2022-03-16
213947,전라북도,15397,133622,15390,7,2022-03-16
45487,세종특별자치시,2032,30453,2032,0,2022-03-16
506552,인천광역시,28464,143189,28453,11,2022-03-16
173626,강원도,9653,70012,9649,4,2022-03-16
429712,경상남도,21898,233798,21896,2,2022-03-16
261872,경상북도,16782,145465,16780,2,2022-03-16
257572,충청남도,13702,77102,13702,0,2022-03-16
187365,대전광역시,8813,59136,8812,1,2022-03-16
2149993,경기도,94809,234368,94806,3,2022-03-16
539517,인천광역시,32965,143186,32964,1,2022-03-17
50721,세종특별자치시,5234,32369,5234,0,2022-03-17
324347,대구광역시,24468,205676,24468,0,2022-03-17
281039,경상북도,19167,147354,19157,10,2022-03-17
232558,전라북도,18611,142481,18607,4,2022-03-17
209441,충청북도,17780,120789,17774,6,2022-03-17
638008,부산광역시,42435,111549,42434,1,2022-03-17
280561,충청남도,22989,100974,22987,2,2022-03-17
2331981,경기도,181994,234668,181983,11,2022-03-17
2445654,경기도,113673,331212,113673,0,2022-03-18
210710,전라남도,11364,6967,11363,1,2022-03-18
340360,대구광역시,16013,214907,16013,0,2022-03-18
294803,충청남도,14242,115463,14242,0,2022-03-18
211178,대전광역시,11332,59140,11332,0,2022-03-18
221613,충청북도,12172,128506,12170,2,2022-03-18
243447,전라북도,10889,153345,10888,1,2022-03-18
103558,제주특별자치도,4412,72786,4412,0,2022-03-18
299071,경상북도,18032,147605,18029,3,2022-03-18
200476,강원도,11401,76537,11401,0,2022-03-18
230126,광주광역시,15447,14999,15444,3,2022-03-18
663512,부산광역시,25504,112113,25504,0,2022-03-18
565315,인천광역시,25798,152109,25797,1,2022-03-18
171489,울산광역시,7866,108713,7866,0,2022-03-18
689261,부산광역시,25759,282025,25759,0,2022-03-19
211016,강원도,10542,82795,10540,2,2022-03-19
310429,충청남도,15626,139115,15625,1,2022-03-19
56958,세종특별자치시,3121,36759,3121,0,2022-03-19
179342,울산광역시,7853,108722,7853,0,2022-03-19
520713,경상남도,22734,296531,22732,2,2022-03-19
222032,대전광역시,10854,59146,10854,0,2022-03-19
1976240,서울특별시,82132,450236,82132,0,2022-03-19
253370,전라북도,9923,164605,9922,1,2022-03-19
355201,대구광역시,14845,226678,14845,0,2022-03-19
2635639,경기도,88480,439111,88479,1,2022-03-20
186663,울산광역시,7321,108722,7321,0,2022-03-20
545049,경상남도,24336,296531,24335,1,2022-03-20
251723,광주광역시,10031,15057,10028,3,2022-03-20
58909,세종특별자치시,1951,36759,1951,0,2022-03-20
220213,강원도,9197,82795,9196,1,2022-03-20
327002,경상북도,12990,147896,12990,0,2022-03-20
323074,충청남도,12645,139115,12645,0,2022-03-20
233517,대전광역시,11485,59146,11485,0,2022-03-20
2042110,서울특별시,65870,450236,65870,0,2022-03-20
331801,충청남도,8727,139115,8727,0,2022-03-21
717781,부산광역시,8977,282025,8977,0,2022-03-21
119471,제주특별자치도,3292,77750,3292,0,2022-03-21
617378,인천광역시,12086,152109,12086,0,2022-03-21
241907,대전광역시,8390,59146,8390,0,2022-03-21
250183,충청북도,5375,138636,5374,1,2022-03-21
61279,세종특별자치시,2370,36759,2370,0,2022-03-21
190902,울산광역시,4239,108722,4239,0,2022-03-21
2692548,경기도,56909,439111,56909,0,2022-03-21
557019,경상남도,11970,296531,11968,2,2022-03-21
2083188,서울특별시,41078,450236,41078,0,2022-03-21
237251,강원도,10428,92225,0,10428,2022-03-22
251499,전라남도,12279,6970,1,12280,2022-03-22
742457,부산광역시,24707,282459,24707,0,2022-03-22
251499,전라남도,12280,6970,12279,1,2022-03-22
64613,세종특별자치시,3334,42724,3334,0,2022-03-22
122662,제주특별자치도,3191,94088,0,3191,2022-03-22
346953,충청남도,15152,165990,15152,0,2022-03-22
251780,대전광역시,9873,59220,0,9873,2022-03-22
392298,대구광역시,17360,259941,17360,0,2022-03-22
581709,경상남도,24707,296516,24703,4,2022-03-22
267168,광주광역시,6985,15090,1,6986,2022-03-22
283511,전라북도,12584,164593,0,12584,2022-03-22
262002,충청북도,11828,164491,1,11829,2022-03-22
237251,강원도,10428,92225,10428,0,2022-03-22
634945,인천광역시,17568,167661,1,17569,2022-03-22
346953,충청남도,15152,165990,0,15152,2022-03-22
64613,세종특별자치시,3334,42724,0,3334,2022-03-22
2148186,서울특별시,65033,480318,65033,0,2022-03-22
122662,제주특별자치도,3191,94088,3191,0,2022-03-22
251780,대전광역시,9873,59220,9873,0,2022-03-22
351205,경상북도,14432,148289,14429,3,2022-03-22
742457,부산광역시,24707,282459,0,24707,2022-03-22
2788761,경기도,96257,439083,96256,1,2022-03-22
68065,세종특별자치시,3452,47370,3452,0,2022-03-23
659886,인천광역시,24941,181963,24941,0,2022-03-23
768448,부산광역시,26062,282821,26062,0,2022-03-23
128233,제주특별자치도,5571,94088,5571,0,2022-03-23
365829,충청남도,18877,200663,18877,0,2022-03-23
613890,경상남도,32193,393831,32190,3,2022-03-23
299419,전라북도,15909,197046,15905,4,2022-03-23
278644,충청북도,16656,179436,16655,1,2022-03-23
371992,경상북도,20786,148281,20784,2,2022-03-23
266926,전라남도,15432,6974,15430,2,2022-03-23
279355,광주광역시,12187,15090,12185,2,2022-03-23
428852,대구광역시,15700,297433,15700,0,2022-03-24
382261,충청남도,16432,239985,16432,0,2022-03-24
684576,인천광역시,24691,190198,24689,2,2022-03-24
3033103,경기도,107472,439830,107472,0,2022-03-24
133263,제주특별자치도,5030,100313,5030,0,2022-03-24
638957,경상남도,25067,393821,25066,1,2022-03-24
71811,세종특별자치시,3746,49898,3746,0,2022-03-24
291820,광주광역시,12465,15090,12463,2,2022-03-24
263091,강원도,11527,94086,11521,6,2022-03-24
218451,울산광역시,8356,158777,8356,0,2022-03-24
280617,전라남도,13691,6975,13690,1,2022-03-24
660619,경상남도,21664,460063,2,21666,2022-03-25
325155,전라북도,12824,207927,2,12826,2022-03-25
3120770,경기도,87703,439984,2,87705,2022-03-25
3120770,경기도,87705,439984,87703,2,2022-03-25
442857,대구광역시,14008,312142,14008,0,2022-03-25
405151,경상북도,15061,148280,15057,4,2022-03-25
273633,강원도,10542,100263,10542,0,2022-03-25
2393995,서울특별시,66943,516701,66941,2,2022-03-25
225881,울산광역시,7433,167090,0,7433,2022-03-25
442857,대구광역시,14008,312142,0,14008,2022-03-25
302786,충청북도,11556,201635,11556,0,2022-03-25
325155,전라북도,12826,207927,12824,2,2022-03-25
302786,충청북도,11556,201635,0,11556,2022-03-25
75297,세종특별자치시,3486,52514,3486,0,2022-03-25
660619,경상남도,21666,460063,21664,2,2022-03-25
273633,강원도,10542,100263,0,10542,2022-03-25
293285,전라남도,12670,6975,0,12670,2022-03-25
706346,인천광역시,21773,190339,21773,0,2022-03-25
409227,충청남도,13167,291028,13167,0,2022-03-26
233329,울산광역시,7450,177237,7450,0,2022-03-26
723129,인천광역시,16785,220559,16785,0,2022-03-26
457070,대구광역시,14217,324820,14217,0,2022-03-26
297036,대전광역시,11202,118865,11202,0,2022-03-26
337357,전라북도,12202,208050,12200,2,2022-03-26
683298,경상남도,22679,483717,22676,3,2022-03-26
283676,강원도,10043,106402,10041,2,2022-03-26
820223,부산광역시,16362,283577,16362,0,2022-03-26
470288,대구광역시,13218,324820,13218,0,2022-03-27
320921,광주광역시,8933,15135,8932,1,2022-03-27
80648,세종특별자치시,2344,54882,2344,0,2022-03-27
423018,충청남도,13791,291028,13791,0,2022-03-27
292936,강원도,9260,106402,9256,4,2022-03-27
240190,울산광역시,6861,177237,6861,0,2022-03-27
703851,경상남도,20553,483717,20550,3,2022-03-27
147144,제주특별자치도,5010,115383,5010,0,2022-03-27
834677,부산광역시,14454,283577,14454,0,2022-03-27
434999,경상북도,14675,148280,14672,3,2022-03-27
243949,울산광역시,3759,177237,3759,0,2022-03-28
82866,세종특별자치시,2218,54882,2218,0,2022-03-28
328402,광주광역시,7481,15135,7481,0,2022-03-28
715474,경상남도,11623,483717,11622,1,2022-03-28
444400,경상북도,9401,148280,9400,1,2022-03-28
841323,부산광역시,6646,283577,6646,0,2022-03-28
326825,전라남도,8398,6976,8397,1,2022-03-28
299871,강원도,6935,106402,6931,4,2022-03-28
331028,충청북도,5835,210468,5834,1,2022-03-28
475520,대구광역시,5232,324820,5232,0,2022-03-28
2551327,서울특별시,34190,548170,34189,1,2022-03-28
459307,경상북도,14911,0,14910,1,2022-03-29
775252,인천광역시,18826,0,18826,0,2022-03-29
310379,강원도,10508,0,10508,0,2022-03-29
153473,제주특별자치도,3329,0,3329,0,2022-03-29
493331,대구광역시,17817,0,17817,0,2022-03-29
737964,경상남도,22498,0,22496,2,2022-03-29
861246,부산광역시,19969,0,19969,0,2022-03-29
159215,제주특별자치도,5744,0,5744,0,2022-03-30
333638,대전광역시,11252,0,11252,0,2022-03-30
332,광주광역시,12301,0,12299,2,2022-03-30
236,울산광역시,9094,0,9094,0,2022-03-30
4256,경기도,117029,0,117029,0,2022-03-30
409,대전광역시,11252,0,11252,0,2022-03-30
798508,인천광역시,23261,0,23261,0,2022-03-30
383493,전라북도,13253,0,13248,5,2022-03-30
359663,충청북도,15579,0,15579,0,2022-03-30
764996,경상남도,27038,0,27037,1,2022-03-30
348623,광주광역시,12301,0,12299,2,2022-03-30
479469,경상북도,20165,0,20161,4,2022-03-30
536,전라북도,13253,0,13248,5,2022-03-30
461,강원도,13113,0,13113,0,2022-03-30
3553139,경기도,117029,0,117029,0,2022-03-30
89587,세종특별자치시,4248,0,4248,0,2022-03-30
1479,부산광역시,16447,0,16447,0,2022-03-30
357916,전라남도,17462,0,17462,0,2022-03-30
463926,충청남도,18969,0,18969,0,2022-03-30
164289,제주특별자치도,5074,0,5074,0,2022-03-31
343696,대전광역시,10058,0,10058,0,2022-03-31
394784,전라북도,11295,0,11294,1,2022-03-31
334151,강원도,10665,0,10665,0,2022-03-31
405421,전라북도,10640,0,10640,0,2022-04-01
272729,울산광역시,5813,0,5813,0,2022-04-01
491428,충청남도,13145,0,13145,0,2022-04-01
369269,광주광역시,9286,0,9286,0,2022-04-01
535262,대구광역시,11382,0,11382,0,2022-04-01
351789,대전광역시,8093,0,8093,0,2022-04-01
383445,전라남도,11826,0,11824,2,2022-04-01
801564,경상남도,17255,0,17250,5,2022-04-01
831419,인천광역시,14797,0,14797,0,2022-04-01
168162,제주특별자치도,3873,0,3873,0,2022-04-01
2810973,서울특별시,51717,0,51717,0,2022-04-01
171933,제주특별자치도,3771,0,3771,0,2022-04-02
390468,충청북도,9326,0,9324,2,2022-04-02
98576,세종특별자치시,2370,0,2370,0,2022-04-02
913271,부산광역시,10691,0,10691,0,2022-04-02
3784881,경기도,71525,0,71525,0,2022-04-02
405039,전라남도,10438,0,10437,1,2022-04-03
384294,광주광역시,7001,0,6998,3,2022-04-03
832621,경상남도,15122,0,15119,3,2022-04-03
859094,인천광역시,13395,0,13395,0,2022-04-03
283372,울산광역시,5049,0,5049,0,2022-04-03
366746,대전광역시,6972,0,6972,0,2022-04-03
399245,충청북도,8777,0,8776,1,2022-04-03
2901742,서울특별시,42109,0,42109,0,2022-04-03
3883961,경기도,36937,0,36937,0,2022-04-04
364982,강원도,5217,0,5216,1,2022-04-04
410998,전라남도,5959,0,5959,0,2022-04-04
573220,대구광역시,13540,0,13540,0,2022-04-05
532145,충청남도,12014,0,12013,1,2022-04-05
180486,제주특별자치도,2711,0,2711,0,2022-04-05
291312,울산광역시,5459,0,5459,0,2022-04-05
421985,전라남도,10990,0,10989,1,2022-04-05
422885,충청북도,10267,0,10264,3,2022-04-06
449213,전라북도,10482,0,10482,0,2022-04-06
106585,세종특별자치시,2175,0,2175,0,2022-04-06
894831,인천광역시,14845,0,14844,1,2022-04-06
434370,전라남도,12387,0,12386,1,2022-04-06
383250,강원도,10012,0,10012,0,2022-04-06
388183,대전광역시,9072,0,9072,0,2022-04-06
949213,부산광역시,10485,0,10485,0,2022-04-06
390879,강원도,7633,0,7628,5,2022-04-07
3102577,서울특별시,36212,0,36212,0,2022-04-08
452946,전라남도,8672,0,8671,1,2022-04-08
398309,강원도,7433,0,7425,8,2022-04-08
469524,충청북도,7407,0,7407,0,2022-04-13
499558,전라북도,8005,0,8002,3,2022-04-13
957801,경상남도,8764,0,8763,1,2022-04-14
987990,인천광역시,2487,0,2487,0,2022-04-18
1000093,인천광역시,5435,0,5435,0,2022-04-20
345351,울산광역시,1740,0,1740,0,2022-04-23
468815,강원도,1280,0,1280,0,2022-04-25
3467402,서울특별시,9109,0,9109,0,2022-04-28
130293,세종특별자치시,343,0,343,0,2022-04-29
482034,대전광역시,1337,0,1337,0,2022-05-01
561989,전라남도,2550,0,2550,0,2022-05-03
1056811,부산광역시,2870,0,2870,0,2022-05-03
3505780,서울특별시,7436,0,7436,0,2022-05-04
571104,전라북도,1191,0,1189,2,2022-05-06
1064171,부산광역시,2278,0,2278,0,2022-05-07
725969,대구광역시,2421,0,2421,0,2022-05-08
362292,울산광역시,1118,0,1118,0,2022-05-08
1050289,인천광역시,2555,0,2550,5,2022-05-10
134240,세종특별자치시,371,0,371,0,2022-05-11
1062127,경상남도,2259,0,2258,1,2022-05-12
134571,세종특별자치시,331,0,331,0,2022-05-12
1074793,부산광역시,1602,0,1602,0,2022-05-13
498544,강원도,1194,0,1193,1,2022-05-13
229562,제주특별자치도,405,0,405,0,2022-05-14
498363,대전광역시,890,0,888,2,2022-05-14
3565332,서울특별시,4025,0,4025,0,2022-05-15
135509,세종특별자치시,160,0,160,0,2022-05-16
3572888,서울특별시,5889,0,5889,0,2022-05-17
369825,울산광역시,834,0,834,0,2022-05-17
501851,대전광역시,1026,0,1026,0,2022-05-18
585699,전라남도,1041,0,1040,1,2022-05-19
1083934,인천광역시,475,0,436,39,2022-07-01
561376,충청북도,264,0,253,11,2022-07-01
385937,울산광역시,291,0,290,1,2022-07-01
723146,충청남도,317,0,317,0,2022-07-01
537811,광주광역시,171,0,167,4,2022-07-01
1104299,경상남도,557,0,542,15,2022-07-01
525460,강원도,241,0,236,5,2022-07-01
140672,세종특별자치시,55,0,54,1,2022-07-01
792538,경상북도,464,0,453,11,2022-07-01
239466,제주특별자치도,216,0,206,10,2022-07-02
561641,충청북도,265,0,253,12,2022-07-02
537975,광주광역시,164,0,157,7,2022-07-02
602587,전라남도,243,0,236,7,2022-07-02
386248,울산광역시,311,0,311,0,2022-07-02
1107720,부산광역시,611,0,608,3,2022-07-02
4991749,경기도,2819,0,2800,19,2022-07-02
525773,강원도,313,0,311,2,2022-07-02
517526,대전광역시,274,0,274,0,2022-07-02
606357,전라북도,274,0,264,10,2022-07-02
773488,대구광역시,369,0,364,5,2022-07-02
723522,충청남도,381,0,379,2,2022-07-02
517767,대전광역시,241,0,237,4,2022-07-03
526042,강원도,269,0,257,12,2022-07-03
386533,울산광역시,285,0,283,2,2022-07-03
561856,충청북도,215,0,209,6,2022-07-03
1105463,경상남도,588,0,572,16,2022-07-03
602835,전라남도,248,0,241,7,2022-07-03
723940,충청남도,418,0,412,6,2022-07-03
538163,광주광역시,188,0,181,7,2022-07-03
140821,세종특별자치시,70,0,70,0,2022-07-03
773782,대구광역시,294,0,291,3,2022-07-03
517980,대전광역시,213,0,211,2,2022-07-04
538307,광주광역시,144,0,130,14,2022-07-04
140878,세종특별자치시,57,0,55,2,2022-07-04
3674645,서울특별시,1161,0,1161,0,2022-07-04
526277,강원도,235,0,227,8,2022-07-04
1085373,인천광역시,348,0,282,66,2022-07-04
387146,울산광역시,465,0,462,3,2022-07-05
607152,전라북도,401,0,396,5,2022-07-05
774712,대구광역시,677,0,672,5,2022-07-05
526808,강원도,532,0,531,1,2022-07-05
5001197,경기도,4896,0,4881,15,2022-07-05
518415,대전광역시,435,0,435,0,2022-07-05
140995,세종특별자치시,117,0,108,9,2022-07-05
724765,충청남도,585,0,583,2,2022-07-05
1086354,인천광역시,983,0,920,63,2022-07-05
794547,경상북도,657,0,643,14,2022-07-05
775358,대구광역시,646,0,627,19,2022-07-06
3684190,서울특별시,4770,0,4768,2,2022-07-06
141148,세종특별자치시,153,0,150,3,2022-07-06
562922,충청북도,488,0,467,21,2022-07-06
603827,전라남도,459,0,452,7,2022-07-06
240513,제주특별자치도,381,0,375,6,2022-07-06
387664,울산광역시,518,0,507,11,2022-07-06
725430,충청남도,665,0,662,3,2022-07-06
607628,전라북도,479,0,464,15,2022-07-06
518868,대전광역시,453,0,451,2,2022-07-06
1088406,인천광역시,983,0,927,56,2022-07-07
608086,전라북도,458,0,449,9,2022-07-07
776016,대구광역시,658,0,649,9,2022-07-07
563363,충청북도,441,0,430,11,2022-07-07
388144,울산광역시,480,0,472,8,2022-07-07
726129,충청남도,699,0,696,3,2022-07-07
240926,제주특별자치도,413,0,408,5,2022-07-07
1112045,부산광역시,1157,0,1155,2,2022-07-07
5011349,경기도,4983,0,4967,16,2022-07-07
141259,세종특별자치시,111,0,107,4,2022-07-07
527965,강원도,561,0,548,13,2022-07-07
796286,경상북도,798,0,782,16,2022-07-07
539237,광주광역시,313,0,303,10,2022-07-07
563857,충청북도,494,0,487,7,2022-07-08
388634,울산광역시,490,0,484,6,2022-07-08
528451,강원도,486,0,478,8,2022-07-08
726901,충청남도,772,0,762,10,2022-07-08
1113285,부산광역시,1240,0,1240,0,2022-07-08
1089384,인천광역시,978,0,932,46,2022-07-08
608629,전라북도,544,0,535,9,2022-07-08
604618,전라남도,380,0,371,9,2022-07-08
519917,대전광역시,561,0,560,1,2022-07-08
539599,광주광역시,362,0,355,7,2022-07-08
141424,세종특별자치시,165,0,160,5,2022-07-08
3693368,서울특별시,4605,0,4605,0,2022-07-08
141600,세종특별자치시,176,0,173,3,2022-07-09
539949,광주광역시,350,0,343,7,2022-07-09
564423,충청북도,567,0,559,8,2022-07-09
727661,충청남도,760,0,747,13,2022-07-09
777354,대구광역시,712,0,701,11,2022-07-09
389214,울산광역시,580,0,577,3,2022-07-09
609146,전라북도,519,0,508,11,2022-07-09
3698267,서울특별시,4900,0,4897,3,2022-07-09
5022377,경기도,5629,0,5595,34,2022-07-09
605094,전라남도,477,0,472,5,2022-07-09
1111037,경상남도,1095,0,1079,16,2022-07-09
242178,제주특별자치도,492,0,484,8,2022-07-10
540319,광주광역시,370,0,351,19,2022-07-10
1091379,인천광역시,931,0,868,63,2022-07-10
1112098,경상남도,1061,0,1041,20,2022-07-10
609720,전라북도,574,0,551,23,2022-07-10
529432,강원도,435,0,433,2,2022-07-10
3703511,서울특별시,5244,0,5238,6,2022-07-10
564985,충청북도,562,0,550,12,2022-07-10
728447,충청남도,786,0,774,12,2022-07-10
5027825,경기도,5448,0,5437,11,2022-07-10
798693,경상북도,903,0,877,26,2022-07-10
529745,강원도,313,0,310,3,2022-07-11
5031812,경기도,3987,0,3976,11,2022-07-11
390191,울산광역시,331,0,331,0,2022-07-11
605770,전라남도,236,0,229,7,2022-07-11
141899,세종특별자치시,103,0,103,0,2022-07-11
242537,제주특별자치도,359,0,355,4,2022-07-11
521410,대전광역시,469,0,465,4,2022-07-11
728893,충청남도,446,0,438,8,2022-07-11
3706133,서울특별시,2622,0,2619,3,2022-07-11
778296,대구광역시,454,0,447,7,2022-07-11
799227,경상북도,534,0,518,16,2022-07-11
610030,전라북도,310,0,303,7,2022-07-11
565302,충청북도,317,0,313,4,2022-07-11
541248,광주광역시,662,0,656,6,2022-07-12
1114862,경상남도,2106,0,2096,10,2022-07-12
800389,경상북도,1162,0,1151,11,2022-07-12
779728,대구광역시,1433,0,1409,24,2022-07-12
1093934,인천광역시,1917,0,1831,86,2022-07-12
391192,울산광역시,1001,0,998,3,2022-07-12
243079,제주특별자치도,542,0,528,14,2022-07-12
1119149,부산광역시,2669,0,2665,4,2022-07-12
530633,강원도,889,0,885,4,2022-07-12
5042098,경기도,10306,0,10280,26,2022-07-12
802039,경상북도,1650,0,1626,24,2022-07-13
607373,전라남도,850,0,839,11,2022-07-13
612068,전라북도,1050,0,1032,18,2022-07-13
523292,대전광역시,968,0,956,12,2022-07-13
244043,제주특별자치도,964,0,950,14,2022-07-13
531679,강원도,1047,0,1037,10,2022-07-13
542062,광주광역시,814,0,794,20,2022-07-13
1121652,부산광역시,2505,0,2501,4,2022-07-13
142591,세종특별자치시,375,0,369,6,2022-07-13
567346,충청북도,1069,0,1032,37,2022-07-13
3724897,서울특별시,9363,0,9353,10,2022-07-13
781157,대구광역시,1429,0,1405,24,2022-07-13
142857,세종특별자치시,266,0,260,6,2022-07-14
1124010,부산광역시,2361,0,2357,4,2022-07-14
782438,대구광역시,1281,0,1266,15,2022-07-14
524314,대전광역시,1022,0,1011,11,2022-07-14
1097991,인천광역시,1967,0,1881,86,2022-07-14
1119111,경상남도,2085,0,2058,27,2022-07-14
393407,울산광역시,1086,0,1078,8,2022-07-14
803612,경상북도,1573,0,1555,18,2022-07-14
532716,강원도,1037,0,1029,8,2022-07-14
5063892,경기도,10635,0,10590,45,2022-07-14
542862,광주광역시,800,0,785,15,2022-07-14
3734550,서울특별시,9655,0,9645,10,2022-07-14
613215,전라북도,1149,0,1127,22,2022-07-14
608223,전라남도,850,0,844,6,2022-07-14
394461,울산광역시,1054,0,1044,10,2022-07-15
609078,전라남도,855,0,845,10,2022-07-15
734712,충청남도,1416,0,1406,10,2022-07-15
1121175,경상남도,2064,0,2042,22,2022-07-15
1126544,부산광역시,2536,0,2534,2,2022-07-15
614284,전라북도,1070,0,1064,6,2022-07-15
805230,경상북도,1618,0,1596,22,2022-07-15
245774,제주특별자치도,878,0,872,6,2022-07-15
525320,대전광역시,1006,0,998,8,2022-07-15
533836,강원도,1120,0,1112,8,2022-07-15
1100085,인천광역시,2095,0,2026,69,2022-07-15
543678,광주광역시,816,0,810,6,2022-07-15
783984,대구광역시,1546,0,1534,12,2022-07-15
5074415,경기도,10530,0,10508,22,2022-07-15
615429,전라북도,1145,0,1136,9,2022-07-16
1123473,경상남도,2299,0,2282,17,2022-07-16
1129157,부산광역시,2617,0,2611,6,2022-07-16
1102212,인천광역시,2127,0,2061,66,2022-07-16
609967,전라남도,889,0,881,8,2022-07-16
544490,광주광역시,812,0,797,15,2022-07-16
526371,대전광역시,1055,0,1044,11,2022-07-16
246741,제주특별자치도,967,0,957,10,2022-07-16
143421,세종특별자치시,305,0,302,3,2022-07-16
785319,대구광역시,1335,0,1316,19,2022-07-16
736334,충청남도,1640,0,1620,20,2022-07-16
570712,충청북도,1283,0,1273,10,2022-07-16
1104315,인천광역시,2103,0,2037,66,2022-07-17
397008,울산광역시,1369,0,1361,8,2022-07-17
247774,제주특별자치도,1033,0,1023,10,2022-07-17
737854,충청남도,1520,0,1512,8,2022-07-17
536104,강원도,1158,0,1146,12,2022-07-17
1125704,경상남도,2231,0,2209,22,2022-07-17
1131725,부산광역시,2568,0,2566,2,2022-07-17
808533,경상북도,1683,0,1663,20,2022-07-17
143738,세종특별자치시,317,0,313,4,2022-07-17
616674,전라북도,1245,0,1230,15,2022-07-17
786495,대구광역시,1176,0,1162,14,2022-07-17
545427,광주광역시,937,0,912,25,2022-07-17
610875,전라남도,908,0,906,2,2022-07-17
527543,대전광역시,1172,0,1150,22,2022-07-17
528301,대전광역시,758,0,749,9,2022-07-18
611422,전라남도,547,0,540,7,2022-07-18
572708,충청북도,717,0,702,15,2022-07-18
536782,강원도,678,0,668,10,2022-07-18
1132975,부산광역시,1250,0,1247,3,2022-07-18
787517,대구광역시,1022,0,1008,14,2022-07-18
144007,세종특별자치시,269,0,264,5,2022-07-18
809601,경상북도,1068,0,1049,19,2022-07-18
5105171,경기도,8268,0,8241,27,2022-07-18
3766412,서울특별시,4896,0,4892,4,2022-07-18
538791,강원도,2009,0,2006,3,2022-07-19
789938,대구광역시,2423,0,2412,11,2022-07-19
574694,충청북도,1987,0,1975,12,2022-07-19
619449,전라북도,2095,0,2084,11,2022-07-19
530255,대전광역시,1954,0,1926,28,2022-07-19
1130838,경상남도,3970,0,3944,26,2022-07-19
3784432,서울특별시,18038,0,18033,5,2022-07-19
399684,울산광역시,2068,0,2066,2,2022-07-19
1137865,부산광역시,4892,0,4884,8,2022-07-19
401790,울산광역시,2106,0,2100,6,2022-07-20
1134684,경상남도,3846,0,3824,22,2022-07-20
1142277,부산광역시,4413,0,4407,6,2022-07-20
251766,제주특별자치도,1940,0,1926,14,2022-07-20
532314,대전광역시,2059,0,2028,31,2022-07-20
744457,충청남도,2865,0,2845,20,2022-07-20
5146619,경기도,21362,0,21318,44,2022-07-20
576902,충청북도,2210,0,2187,23,2022-07-20
145086,세종특별자치시,522,0,504,18,2022-07-20
792509,대구광역시,2573,0,2557,16,2022-07-20
3801622,서울특별시,17199,0,17189,10,2022-07-20
616376,전라남도,1694,0,1686,8,2022-07-21
1118802,인천광역시,3939,0,3863,76,2022-07-21
747095,충청남도,2638,0,2632,6,2022-07-21
145578,세종특별자치시,492,0,488,4,2022-07-21
5166113,경기도,19503,0,19480,23,2022-07-21
534343,대전광역시,2029,0,2012,17,2022-07-21
1146406,부산광역시,4129,0,4125,4,2022-07-21
1138162,경상남도,3479,0,3463,16,2022-07-21
542988,강원도,1993,0,1978,15,2022-07-21
550747,광주광역시,1650,0,1628,22,2022-07-21
3818284,서울특별시,16670,0,16662,8,2022-07-21
578795,충청북도,1893,0,1881,12,2022-07-21
405680,울산광역시,1871,0,1869,2,2022-07-22
1122504,인천광역시,3710,0,3657,53,2022-07-22
254837,제주특별자치도,1471,0,1457,14,2022-07-22
545128,강원도,2140,0,2125,15,2022-07-22
618004,전라남도,1631,0,1621,10,2022-07-22
146106,세종특별자치시,528,0,523,5,2022-07-22
5184927,경기도,18822,0,18784,38,2022-07-22
536186,대전광역시,1843,0,1825,18,2022-07-22
820674,경상북도,2900,0,2882,18,2022-07-22
797201,대구광역시,2287,0,2271,16,2022-07-22
3833658,서울특별시,15379,0,15370,9,2022-07-22
552344,광주광역시,1597,0,1573,24,2022-07-22
146597,세종특별자치시,493,0,486,7,2022-07-23
583104,충청북도,2140,0,2125,15,2022-07-23
752412,충청남도,2676,0,2659,17,2022-07-23
5203297,경기도,18380,0,18338,42,2022-07-23
799760,대구광역시,2559,0,2550,9,2022-07-23
3848480,서울특별시,14830,0,14825,5,2022-07-23
619751,전라남도,1748,0,1735,13,2022-07-23
538159,대전광역시,1976,0,1960,16,2022-07-23
553978,광주광역시,1634,0,1612,22,2022-07-23
547158,강원도,2030,0,2021,9,2022-07-23
823617,경상북도,2943,0,2931,12,2022-07-23
409529,울산광역시,1984,0,1978,6,2022-07-24
1129750,인천광역시,3490,0,3425,65,2022-07-24
801683,대구광역시,1923,0,1907,16,2022-07-24
555648,광주광역시,1670,0,1636,34,2022-07-24
3862289,서울특별시,13809,0,13806,3,2022-07-24
826622,경상북도,3005,0,2966,39,2022-07-24
147182,세종특별자치시,585,0,582,3,2022-07-24
5220594,경기도,17297,0,17273,24,2022-07-24
1149019,경상남도,3517,0,3503,14,2022-07-24
540145,대전광역시,1986,0,1977,9,2022-07-24
621527,전라남도,1776,0,1760,16,2022-07-24
3868256,서울특별시,5967,0,5965,2,2022-07-25
586620,충청북도,1259,0,1241,18,2022-07-25
259309,제주특별자치도,1207,0,1193,14,2022-07-25
1159131,부산광역시,1437,0,1431,6,2022-07-25
541396,대전광역시,1251,0,1233,18,2022-07-25
5231497,경기도,10903,0,10876,27,2022-07-25
803115,대구광역시,1432,0,1423,9,2022-07-25
1131698,인천광역시,1948,0,1880,68,2022-07-25
756458,충청남도,1401,0,1382,19,2022-07-25
631831,전라북도,1216,0,1200,16,2022-07-25
1150966,경상남도,1947,0,1926,21,2022-07-25
5258766,경기도,27280,0,27256,24,2022-07-26
260931,제주특별자치도,1624,0,1606,18,2022-07-26
148210,세종특별자치시,796,0,792,4,2022-07-26
760656,충청남도,4198,0,4176,22,2022-07-26
1137061,인천광역시,5363,0,5273,90,2022-07-26
1165446,부산광역시,6318,0,6310,8,2022-07-26
544102,대전광역시,2706,0,2672,34,2022-07-26
412618,울산광역시,2393,0,2393,0,2022-07-26
552596,강원도,2478,0,2471,7,2022-07-26
625059,전라남도,2547,0,2534,13,2022-07-26
559069,광주광역시,2315,0,2290,25,2022-07-26
806559,대구광역시,3444,0,3431,13,2022-07-26
831747,경상북도,3355,0,3326,29,2022-07-26
589628,충청북도,3008,0,2993,15,2022-07-26
149042,세종특별자치시,832,0,825,7,2022-07-27
262985,제주특별자치도,2054,0,2040,14,2022-07-27
638114,전라북도,3371,0,3334,37,2022-07-27
1142324,인천광역시,5314,0,5207,107,2022-07-27
764845,충청남도,4189,0,4184,5,2022-07-27
810435,대구광역시,3879,0,3856,23,2022-07-27
1161907,경상남도,5480,0,5425,55,2022-07-27
555897,강원도,3303,0,3287,16,2022-07-27
592867,충청북도,3242,0,3203,39,2022-07-27
627688,전라남도,2637,0,2630,7,2022-07-27
3911407,서울특별시,20083,0,20077,6,2022-07-27
768503,충청남도,3658,0,3634,24,2022-07-28
1166341,경상남도,4435,0,4416,19,2022-07-28
558750,강원도,2853,0,2841,12,2022-07-28
640911,전라북도,2800,0,2784,16,2022-07-28
149770,세종특별자치시,728,0,722,6,2022-07-28
1147162,인천광역시,4848,0,4752,96,2022-07-28
3929537,서울특별시,18169,0,18158,11,2022-07-28
417669,울산광역시,2377,0,2365,12,2022-07-28
813487,대구광역시,3053,0,3031,22,2022-07-28
264823,제주특별자치도,1839,0,1826,13,2022-07-28
595770,충청북도,2905,0,2881,24,2022-07-28
5310198,경기도,24254,0,24214,40,2022-07-28
1175423,부산광역시,4696,0,4689,7,2022-07-28
840996,경상북도,4287,0,4245,42,2022-07-28
549519,대전광역시,2572,0,2548,24,2022-07-28
1151538,인천광역시,4380,0,4280,100,2022-07-29
632468,전라남도,2366,0,2352,14,2022-07-29
3947049,서울특별시,17517,0,17506,11,2022-07-29
419829,울산광역시,2160,0,2153,7,2022-07-29
1170788,경상남도,4447,0,4425,22,2022-07-29
266445,제주특별자치도,1622,0,1597,25,2022-07-29
150398,세종특별자치시,632,0,622,10,2022-07-29
1180014,부산광역시,4592,0,4584,8,2022-07-29
816984,대구광역시,3498,0,3481,17,2022-07-29
844791,경상북도,3796,0,3770,26,2022-07-29
598347,충청북도,2578,0,2557,21,2022-07-29
552076,대전광역시,2557,0,2534,23,2022-07-29
561522,강원도,2774,0,2768,6,2022-07-29
771999,충청남도,3497,0,3474,23,2022-07-29
5356168,경기도,22433,0,22374,59,2022-07-30
601127,충청북도,2781,0,2762,19,2022-07-30
421925,울산광역시,2097,0,2090,7,2022-07-30
568978,광주광역시,2172,0,2144,28,2022-07-30
634781,전라남도,2316,0,2288,28,2022-07-30
3963626,서울특별시,16588,0,16574,14,2022-07-30
1184534,부산광역시,4522,0,4520,2,2022-07-30
775346,충청남도,3357,0,3345,12,2022-07-30
848603,경상북도,3812,0,3774,38,2022-07-30
554551,대전광역시,2477,0,2459,18,2022-07-30
268282,제주특별자치도,1837,0,1825,12,2022-07-30
564132,강원도,2610,0,2604,6,2022-07-30
1188370,부산광역시,3836,0,3835,1,2022-07-31
571262,광주광역시,2284,0,2258,26,2022-07-31
423995,울산광역시,2070,0,2063,7,2022-07-31
603670,충청북도,2543,0,2528,15,2022-07-31
649768,전라북도,3010,0,2992,18,2022-07-31
5374757,경기도,18589,0,18568,21,2022-07-31
566607,강원도,2475,0,2460,15,2022-07-31
636976,전라남도,2195,0,2185,10,2022-07-31
269865,제주특별자치도,1583,0,1560,23,2022-07-31
822362,대구광역시,2506,0,2487,19,2022-07-31
1159590,인천광역시,3951,0,3876,75,2022-07-31
1179209,경상남도,3973,0,3955,18,2022-07-31
556969,대전광역시,2418,0,2396,22,2022-07-31
852748,경상북도,4145,0,4117,28,2022-07-31
780405,충청남도,1809,0,1781,28,2022-08-01
1162049,인천광역시,2459,0,2301,158,2022-08-01
1190441,부산광역시,2071,0,2067,4,2022-08-01
3985115,서울특별시,7340,0,7337,3,2022-08-01
558457,대전광역시,1488,0,1462,26,2022-08-01
572757,광주광역시,1495,0,1473,22,2022-08-01
151967,세종특별자치시,359,0,349,10,2022-08-01
651347,전라북도,1579,0,1561,18,2022-08-01
605115,충청북도,1445,0,1417,28,2022-08-01
855146,경상북도,2398,0,2379,19,2022-08-01
828795,대구광역시,4486,0,4469,17,2022-08-02
608437,충청북도,3323,0,3293,30,2022-08-02
571175,강원도,3120,0,3109,11,2022-08-02
5417847,경기도,30098,0,30049,49,2022-08-02
427629,울산광역시,2540,0,2532,8,2022-08-02
4009707,서울특별시,24615,0,24600,15,2022-08-02
654998,전라북도,3652,0,3615,37,2022-08-02
784701,충청남도,4297,0,4275,22,2022-08-02
566155,대전광역시,3532,0,3503,29,2022-08-03
1204102,부산광역시,6659,0,6649,10,2022-08-03
790262,충청남도,5561,0,5539,22,2022-08-03
645188,전라남도,3635,0,3614,21,2022-08-03
430486,울산광역시,2859,0,2829,30,2022-08-03
5449537,경기도,31701,0,31638,63,2022-08-03
575787,강원도,4613,0,4589,24,2022-08-03
833552,대구광역시,4761,0,4746,15,2022-08-03
274349,제주특별자치도,1968,0,1954,14,2022-08-03
1174028,인천광역시,6266,0,6163,103,2022-08-03
4032709,서울특별시,23023,0,22986,37,2022-08-03
659302,전라북도,4304,0,4276,28,2022-08-03
153921,세종특별자치시,950,0,933,17,2022-08-03
616012,충청북도,3622,0,3598,24,2022-08-04
871422,경상북도,5687,0,5659,28,2022-08-04
4052939,서울특별시,20239,0,20225,14,2022-08-04
837945,대구광역시,4394,0,4377,17,2022-08-04
569469,대전광역시,3314,0,3293,21,2022-08-04
582374,광주광역시,3416,0,3375,41,2022-08-04
663532,전라북도,4231,0,4203,28,2022-08-04
580156,강원도,4370,0,4362,8,2022-08-04
1210285,부산광역시,6186,0,6180,6,2022-08-04
573094,대전광역시,3625,0,3596,29,2022-08-05
877204,경상북도,5783,0,5751,32,2022-08-05
155709,세종특별자치시,873,0,870,3,2022-08-05
1185469,인천광역시,5906,0,5799,107,2022-08-05
585768,광주광역시,3394,0,3367,27,2022-08-05
1216922,부산광역시,6638,0,6629,9,2022-08-05
667648,전라북도,4116,0,4103,13,2022-08-05
842746,대구광역시,4801,0,4781,20,2022-08-05
277946,제주특별자치도,1705,0,1688,17,2022-08-05
584167,강원도,4011,0,3998,13,2022-08-05
5506753,경기도,29427,0,29382,45,2022-08-05
619763,충청북도,3754,0,3718,36,2022-08-05
1206040,경상남도,6385,0,6360,25,2022-08-05
436300,울산광역시,2937,0,2927,10,2022-08-05
5535840,경기도,29097,0,29017,80,2022-08-06
847452,대구광역시,4706,0,4688,18,2022-08-06
439255,울산광역시,2958,0,2947,11,2022-08-06
1223497,부산광역시,6578,0,6567,11,2022-08-06
156532,세종특별자치시,823,0,813,10,2022-08-06
655821,전라남도,3591,0,3568,23,2022-08-06
804135,충청남도,4714,0,4662,52,2022-08-06
4093893,서울특별시,20160,0,20142,18,2022-08-06
279588,제주특별자치도,1642,0,1636,6,2022-08-06
1191061,인천광역시,5595,0,5487,108,2022-08-06
576555,대전광역시,3462,0,3437,25,2022-08-06
671730,전라북도,4085,0,4054,31,2022-08-06
1212800,경상남도,6760,0,6724,36,2022-08-06
588141,강원도,3975,0,3965,10,2022-08-06
591572,강원도,3431,0,3423,8,2022-08-07
4112259,서울특별시,18366,0,18342,24,2022-08-07
1196686,인천광역시,5625,0,5545,80,2022-08-07
852173,대구광역시,4721,0,4686,35,2022-08-07
5562131,경기도,26291,0,26242,49,2022-08-07
1229325,부산광역시,5828,0,5825,3,2022-08-07
580007,대전광역시,3452,0,3431,21,2022-08-07
627331,충청북도,3656,0,3637,19,2022-08-07
888818,경상북도,5893,0,5847,46,2022-08-07
592026,광주광역시,3415,0,3391,24,2022-08-07
442390,울산광역시,3135,0,3115,20,2022-08-07
157395,세종특별자치시,863,0,852,11,2022-08-07
281416,제주특별자치도,1828,0,1814,14,2022-08-07
1219536,경상남도,6736,0,6690,46,2022-08-07
810839,충청남도,2234,0,2222,12,2022-08-08
854458,대구광역시,2285,0,2275,10,2022-08-08
594023,광주광역시,1997,0,1970,27,2022-08-08
1231947,부산광역시,2622,0,2613,9,2022-08-08
282659,제주특별자치도,1243,0,1229,14,2022-08-08
5577226,경기도,15095,0,15065,30,2022-08-08
1222584,경상남도,3048,0,3016,32,2022-08-08
594081,강원도,2509,0,2491,18,2022-08-08
678443,전라북도,2232,0,2206,26,2022-08-08
629292,충청북도,1961,0,1928,33,2022-08-08
581779,대전광역시,1772,0,1758,14,2022-08-08
1199478,인천광역시,2792,0,2672,120,2022-08-08
4120126,서울특별시,7867,0,7853,14,2022-08-08
157915,세종특별자치시,520,0,508,12,2022-08-08
661154,전라남도,2045,0,2039,6,2022-08-08
892238,경상북도,3420,0,3372,48,2022-08-08
284315,제주특별자치도,1656,0,1638,18,2022-08-09
598839,강원도,4760,0,4749,11,2022-08-09
1207246,인천광역시,7770,0,7640,130,2022-08-09
4149586,서울특별시,29489,0,29470,19,2022-08-09
586730,대전광역시,4952,0,4917,35,2022-08-09
597484,광주광역시,3461,0,3419,42,2022-08-09
861608,대구광역시,7151,0,7132,19,2022-08-09
666170,전라남도,5016,0,4998,18,2022-08-09
898135,경상북도,5898,0,5864,34,2022-08-09
683947,전라북도,5507,0,5481,26,2022-08-09
816791,충청남도,5952,0,5926,26,2022-08-09
634391,충청북도,5100,0,5074,26,2022-08-09
5616226,경기도,39024,0,38975,49,2022-08-09
159068,세종특별자치시,1155,0,1153,2,2022-08-09
1232021,경상남도,9437,0,9366,71,2022-08-09
447511,울산광역시,3523,0,3508,15,2022-08-09
1214957,인천광역시,7715,0,7615,100,2022-08-10
5654300,경기도,38095,0,38016,79,2022-08-10
672028,전라남도,5863,0,5841,22,2022-08-10
906647,경상북도,8512,0,8464,48,2022-08-10
1250865,부산광역시,8917,0,8902,15,2022-08-10
286308,제주특별자치도,1993,0,1977,16,2022-08-10
451704,울산광역시,4197,0,4180,17,2022-08-10
591405,대전광역시,4675,0,4644,31,2022-08-10
868605,대구광역시,6997,0,6979,18,2022-08-10
690031,전라북도,6086,0,6047,39,2022-08-10
1240906,경상남도,8887,0,8834,53,2022-08-10
639739,충청북도,5349,0,5324,25,2022-08-10
602643,광주광역시,5159,0,5119,40,2022-08-10
5689137,경기도,34846,0,34780,66,2022-08-11
454943,울산광역시,3243,0,3216,27,2022-08-11
607445,광주광역시,4804,0,4779,25,2022-08-11
595673,대전광역시,4268,0,4245,23,2022-08-11
288332,제주특별자치도,2024,0,2009,15,2022-08-11
608719,강원도,4607,0,4589,18,2022-08-11
874906,대구광역시,6301,0,6284,17,2022-08-11
695532,전라북도,5501,0,5472,29,2022-08-11
4200150,서울특별시,24516,0,24500,16,2022-08-11
829267,충청남도,5844,0,5809,35,2022-08-11
1249116,경상남도,8211,0,8178,33,2022-08-11
644376,충청북도,4639,0,4609,30,2022-08-11
1221646,인천광역시,6692,0,6613,79,2022-08-11
599470,대전광역시,3797,0,3760,37,2022-08-12
162430,세종특별자치시,984,0,978,6,2022-08-12
611485,광주광역시,4040,0,4013,27,2022-08-12
700528,전라북도,4999,0,4978,21,2022-08-12
880722,대구광역시,5816,0,5796,20,2022-08-12
648612,충청북도,4239,0,4221,18,2022-08-12
458046,울산광역시,3104,0,3086,18,2022-08-12
1266446,부산광역시,7397,0,7393,4,2022-08-12
1228654,인천광역시,7010,0,6939,71,2022-08-12
613030,강원도,4311,0,4287,24,2022-08-12
920435,경상북도,6663,0,6633,30,2022-08-12
1274102,부산광역시,7660,0,7656,4,2022-08-13
1234754,인천광역시,6108,0,5993,115,2022-08-13
886788,대구광역시,6071,0,6054,17,2022-08-13
840231,충청남도,5227,0,5199,28,2022-08-13
5752973,경기도,31123,0,31082,41,2022-08-13
461003,울산광역시,2964,0,2942,22,2022-08-13
926645,경상북도,6210,0,6192,18,2022-08-13
687990,전라남도,5392,0,5372,20,2022-08-13
652788,충청북도,4178,0,4161,17,2022-08-13
292188,제주특별자치도,1874,0,1861,13,2022-08-13
615881,광주광역시,4396,0,4380,16,2022-08-13
4244827,서울특별시,21859,0,21836,23,2022-08-13
603372,대전광역시,3902,0,3870,32,2022-08-13
845830,충청남도,5599,0,5581,18,2022-08-14
463816,울산광역시,2813,0,2808,5,2022-08-14
710430,전라북도,5103,0,5084,19,2022-08-14
620479,강원도,3463,0,3447,16,2022-08-14
892424,대구광역시,5636,0,5619,17,2022-08-14
5782202,경기도,29229,0,29193,36,2022-08-14
1240825,인천광역시,6071,0,5962,109,2022-08-14
4264423,서울특별시,19596,0,19591,5,2022-08-14
657087,충청북도,4299,0,4269,30,2022-08-14
1272359,경상남도,7715,0,7684,31,2022-08-14
164543,세종특별자치시,1049,0,1044,5,2022-08-14
620367,광주광역시,4486,0,4463,23,2022-08-14
294101,제주특별자치도,1913,0,1897,16,2022-08-14
895462,대구광역시,3038,0,3027,11,2022-08-15
4272669,서울특별시,8246,0,8239,7,2022-08-15
5798289,경기도,16087,0,16058,29,2022-08-15
622848,강원도,2369,0,2355,14,2022-08-15
695798,전라남도,2782,0,2775,7,2022-08-15
165065,세종특별자치시,522,0,514,8,2022-08-15
1276294,경상남도,3935,0,3893,42,2022-08-15
465411,울산광역시,1595,0,1590,5,2022-08-15
659329,충청북도,2242,0,2229,13,2022-08-15
1284039,부산광역시,2929,0,2926,3,2022-08-15
712883,전라북도,2453,0,2441,12,2022-08-15
623081,광주광역시,2714,0,2693,21,2022-08-15
848673,충청남도,2843,0,2813,30,2022-08-15
1243807,인천광역시,2982,0,2885,97,2022-08-15
295574,제주특별자치도,1473,0,1468,5,2022-08-15
1337019,부산광역시,6832,0,6828,4,2022-08-21
171832,세종특별자치시,954,0,950,4,2022-08-21
637490,대전광역시,3772,0,3744,28,2022-08-21
1284760,인천광역시,5428,0,5368,60,2022-08-21
4404221,서울특별시,16743,0,16720,23,2022-08-21
5998003,경기도,25604,0,25578,26,2022-08-21
731129,전라남도,5057,0,5043,14,2022-08-21
687332,충청북도,3794,0,3777,17,2022-08-21
647421,강원도,3030,0,3011,19,2022-08-21
981419,경상북도,6939,0,6906,33,2022-08-21
940816,대구광역시,6435,0,6421,14,2022-08-21
652152,광주광역시,4032,0,4008,24,2022-08-21
1287874,인천광역시,3114,0,3008,106,2022-08-22
1339753,부산광역시,2734,0,2730,4,2022-08-22
486029,울산광역시,1282,0,1280,2,2022-08-22
1335928,경상남도,3788,0,3763,25,2022-08-22
944389,대구광역시,3573,0,3565,8,2022-08-22
985191,경상북도,3772,0,3736,36,2022-08-22
649556,강원도,2135,0,2126,9,2022-08-22
689358,충청북도,2026,0,2014,12,2022-08-22
733762,전라남도,2633,0,2618,15,2022-08-22
172307,세종특별자치시,475,0,470,5,2022-08-22
308385,제주특별자치도,1354,0,1343,11,2022-08-22
6050221,경기도,37242,0,37202,40,2022-08-23
1346243,경상남도,10316,0,10277,39,2022-08-23
753268,전라북도,5393,0,5354,39,2022-08-23
489392,울산광역시,3367,0,3358,9,2022-08-23
658984,광주광역시,4171,0,4147,24,2022-08-23
694053,충청북도,4695,0,4681,14,2022-08-23
740281,전라남도,6527,0,6515,12,2022-08-23
1295992,인천광역시,8199,0,8098,101,2022-08-23
4437282,서울특별시,25679,0,25644,35,2022-08-23
644755,대전광역시,5210,0,5176,34,2022-08-23
991607,경상북도,6419,0,6389,30,2022-08-23
173555,세종특별자치시,1248,0,1234,14,2022-08-23
953024,대구광역시,8639,0,8620,19,2022-08-23
894115,충청남도,6748,0,6704,44,2022-08-23
1000678,경상북도,9073,0,9028,45,2022-08-24
648957,대전광역시,4202,0,4181,21,2022-08-24
758799,전라북도,5532,0,5507,25,2022-08-24
1355853,경상남도,9617,0,9583,34,2022-08-24
698748,충청북도,4699,0,4672,27,2022-08-24
1303036,인천광역시,7101,0,7013,88,2022-08-24
746358,전라남도,6083,0,6071,12,2022-08-24
664730,광주광역시,5746,0,5722,24,2022-08-24
312010,제주특별자치도,2096,0,2074,22,2022-08-24
492655,울산광역시,3265,0,3249,16,2022-08-24
313644,제주특별자치도,1634,0,1622,12,2022-08-25
652618,대전광역시,3661,0,3645,16,2022-08-25
175665,세종특별자치시,944,0,939,5,2022-08-25
702559,충청북도,3811,0,3797,14,2022-08-25
6109867,경기도,27032,0,27007,25,2022-08-25
1007099,경상북도,6422,0,6400,22,2022-08-25
495210,울산광역시,2555,0,2553,2,2022-08-25
661677,강원도,3329,0,3311,18,2022-08-25
668865,광주광역시,4140,0,4124,16,2022-08-25
4475520,서울특별시,17722,0,17707,15,2022-08-25
1363835,경상남도,7982,0,7950,32,2022-08-25
655949,대전광역시,3331,0,3308,23,2022-08-26
497369,울산광역시,2159,0,2156,3,2022-08-26
1372431,부산광역시,6281,0,6276,5,2022-08-26
1370681,경상남도,6853,0,6839,14,2022-08-26
972533,대구광역시,5317,0,5309,8,2022-08-26
664730,강원도,3053,0,3047,6,2022-08-26
705964,충청북도,3406,0,3393,13,2022-08-26
4491244,서울특별시,15757,0,15742,15,2022-08-26
6134390,경기도,24539,0,24510,29,2022-08-26
1012769,경상북도,5670,0,5634,36,2022-08-26
315036,제주특별자치도,1394,0,1381,13,2022-08-26
767374,전라북도,4046,0,4014,32,2022-08-26
499430,울산광역시,2062,0,2055,7,2022-08-27
1377591,경상남도,6910,0,6884,26,2022-08-27
978109,대구광역시,5578,0,5559,19,2022-08-27
675910,광주광역시,3357,0,3336,21,2022-08-27
6157241,경기도,22864,0,22826,38,2022-08-27
771107,전라북도,3735,0,3720,15,2022-08-27
658982,대전광역시,3055,0,3028,27,2022-08-27
709420,충청북도,3456,0,3439,17,2022-08-27
667565,강원도,2835,0,2821,14,2022-08-27
915176,충청남도,4521,0,4490,31,2022-08-27
1378463,부산광역시,6032,0,6025,7,2022-08-27
759937,전라남도,4145,0,4139,6,2022-08-27
316451,제주특별자치도,1415,0,1406,9,2022-08-27
919178,충청남도,4002,0,3980,22,2022-08-28
1323390,인천광역시,4335,0,4258,77,2022-08-28
670024,강원도,2459,0,2451,8,2022-08-28
1383537,부산광역시,5074,0,5066,8,2022-08-28
501346,울산광역시,1916,0,1913,3,2022-08-28
1023351,경상북도,5212,0,5157,55,2022-08-28
661769,대전광역시,2787,0,2774,13,2022-08-28
679145,광주광역시,3235,0,3220,15,2022-08-28
178223,세종특별자치시,814,0,808,6,2022-08-28
763474,전라남도,3537,0,3524,13,2022-08-28
317678,제주특별자치도,1227,0,1220,7,2022-08-28
6177081,경기도,19840,0,19823,17,2022-08-28
774861,전라북도,3754,0,3734,20,2022-08-28
4524644,서울특별시,5756,0,5752,4,2022-08-29
765380,전라남도,1906,0,1899,7,2022-08-29
1325977,인천광역시,2587,0,2469,118,2022-08-29
680639,광주광역시,1494,0,1481,13,2022-08-29
921218,충청남도,2040,0,2024,16,2022-08-29
714016,충청북도,1617,0,1601,16,2022-08-29
6188975,경기도,11894,0,11881,13,2022-08-29
502160,울산광역시,814,0,813,1,2022-08-29
178663,세종특별자치시,440,0,434,6,2022-08-29
671537,강원도,1513,0,1504,9,2022-08-29
1385335,부산광역시,1798,0,1796,2,2022-08-29
984984,대구광역시,1965,0,1953,12,2022-08-29
318517,제주특별자치도,839,0,834,5,2022-08-29
319552,제주특별자치도,1035,0,1025,10,2022-08-30
991092,대구광역시,6108,0,6093,15,2022-08-30
1394061,경상남도,7762,0,7733,29,2022-08-30
780376,전라북도,3957,0,3949,8,2022-08-30
667216,대전광역시,3884,0,3855,29,2022-08-30
1332407,인천광역시,6477,0,6375,102,2022-08-30
1393146,부산광역시,7813,0,7808,5,2022-08-30
717798,충청북도,3789,0,3771,18,2022-08-30
674728,강원도,3192,0,3184,8,2022-08-30
504261,울산광역시,2103,0,2089,14,2022-08-30
769878,전라남도,4523,0,4519,4,2022-08-30
4545050,서울특별시,20418,0,20397,21,2022-08-30
6219245,경기도,30289,0,30268,21,2022-08-30
179728,세종특별자치시,1067,0,1060,7,2022-08-30
1337705,인천광역시,5306,0,5211,95,2022-08-31
678115,강원도,3387,0,3376,11,2022-08-31
4560954,서울특별시,15911,0,15889,22,2022-08-31
1037905,경상북도,6855,0,6824,31,2022-08-31
6245144,경기도,25908,0,25878,30,2022-08-31
687241,광주광역시,3649,0,3623,26,2022-08-31
670419,대전광역시,3203,0,3170,33,2022-08-31
721804,충청북도,4006,0,3985,21,2022-08-31
1398995,부산광역시,5852,0,5845,7,2022-08-31
320983,제주특별자치도,1431,0,1422,9,2022-08-31
996824,대구광역시,5734,0,5706,28,2022-08-31
506145,울산광역시,1884,0,1871,13,2022-08-31
773776,전라남도,3902,0,3886,16,2022-08-31
4574258,서울특별시,13325,0,13313,12,2022-09-01
322030,제주특별자치도,1047,0,1041,6,2022-09-01
788103,전라북도,3442,0,3431,11,2022-09-01
680747,강원도,2634,0,2627,7,2022-09-01
935297,충청남도,3779,0,3740,39,2022-09-01
181255,세종특별자치시,682,0,681,1,2022-09-01
724823,충청북도,3022,0,3008,14,2022-09-01
1042687,경상북도,4782,0,4753,29,2022-09-01
690055,광주광역시,2818,0,2798,20,2022-09-01
673083,대전광역시,2664,0,2646,18,2022-09-01
6265368,경기도,20249,0,20228,21,2022-09-01
507746,울산광역시,1601,0,1599,2,2022-09-01
776823,전라남도,3048,0,3041,7,2022-09-01
1342166,인천광역시,4463,0,4394,69,2022-09-01
1355808,인천광역시,3978,0,3930,48,2022-09-04
1421157,경상남도,4608,0,4584,24,2022-09-04
512119,울산광역시,1463,0,1462,1,2022-09-04
785508,전라남도,2421,0,2414,7,2022-09-04
697162,광주광역시,2365,0,2359,6,2022-09-04
796882,전라북도,2721,0,2710,11,2022-09-04
6328443,경기도,18364,0,18351,13,2022-09-04
946680,충청남도,3333,0,3306,27,2022-09-04
733366,충청북도,2646,0,2627,19,2022-09-04
687729,강원도,2082,0,2078,4,2022-09-04
1056184,경상북도,4425,0,4407,18,2022-09-04
324483,제주특별자치도,756,0,748,8,2022-09-04
1014537,대구광역시,4272,0,4266,6,2022-09-04
4615586,서울특별시,11939,0,11928,11,2022-09-04
1358186,인천광역시,2378,0,2285,93,2022-09-05
798501,전라북도,1619,0,1613,6,2022-09-05
6339125,경기도,10682,0,10672,10,2022-09-05
324979,제주특별자치도,496,0,489,7,2022-09-05
512740,울산광역시,621,0,620,1,2022-09-05
698388,광주광역시,1226,0,1221,5,2022-09-05
1016286,대구광역시,1749,0,1743,6,2022-09-05
786921,전라남도,1413,0,1410,3,2022-09-05
1417495,부산광역시,1392,0,1389,3,2022-09-05
1058409,경상북도,2225,0,2219,6,2022-09-05
4620905,서울특별시,5319,0,5315,4,2022-09-05
1423583,경상남도,2426,0,2420,6,2022-09-05
734731,충청북도,1365,0,1349,16,2022-09-05
183912,세종특별자치시,364,0,352,12,2022-09-05
688986,강원도,1257,0,1248,9,2022-09-05
1429999,경상남도,6417,0,6397,20,2022-09-06
700817,광주광역시,2429,0,2416,13,2022-09-06
4639649,서울특별시,18779,0,18775,4,2022-09-06
790269,전라남도,3350,0,3349,1,2022-09-06
1062697,경상북도,4292,0,4265,27,2022-09-06
1423578,부산광역시,6086,0,6085,1,2022-09-06
6365891,경기도,26783,0,26767,16,2022-09-06
738254,충청북도,3524,0,3507,17,2022-09-06
1364149,인천광역시,5985,0,5898,87,2022-09-06
685605,대전광역시,3266,0,3256,10,2022-09-06
952786,충청남도,4471,0,4463,8,2022-09-06
801848,전라북도,3351,0,3344,7,2022-09-06
515797,울산광역시,1368,0,1361,7,2022-09-07
694542,강원도,2737,0,2730,7,2022-09-07
703730,광주광역시,2913,0,2905,8,2022-09-07
6388708,경기도,22832,0,22798,34,2022-09-07
1435235,경상남도,5239,0,5213,26,2022-09-07
326233,제주특별자치도,689,0,685,4,2022-09-07
185628,세종특별자치시,755,0,754,1,2022-09-07
793016,전라남도,2748,0,2739,9,2022-09-07
1368943,인천광역시,4798,0,4702,96,2022-09-07
4654166,서울특별시,14538,0,14523,15,2022-09-07
956579,충청남도,3793,0,3762,31,2022-09-07
804925,전라북도,3079,0,3062,17,2022-09-07
1071946,경상북도,3937,0,3925,12,2022-09-08
186236,세종특별자치시,609,0,609,0,2022-09-08
807654,전라북도,2730,0,2719,11,2022-09-08
4667217,서울특별시,13066,0,13057,9,2022-09-08
1373189,인천광역시,4248,0,4188,60,2022-09-08
795340,전라남도,2326,0,2319,7,2022-09-08
743884,충청북도,2482,0,2470,12,2022-09-08
696857,강원도,2315,0,2305,10,2022-09-08
959549,충청남도,2980,0,2950,30,2022-09-08
518400,울산광역시,1192,0,1190,2,2022-09-09
1444569,경상남도,4584,0,4568,16,2022-09-09
797702,전라남도,2362,0,2357,5,2022-09-09
186812,세종특별자치시,577,0,576,1,2022-09-09
810104,전라북도,2452,0,2444,8,2022-09-09
1034325,대구광역시,3723,0,3716,7,2022-09-09
6425850,경기도,17872,0,17845,27,2022-09-09
1434175,부산광역시,3606,0,3601,5,2022-09-09
707908,광주광역시,1949,0,1941,8,2022-09-09
692665,대전광역시,2243,0,2219,24,2022-09-09
4679529,서울특별시,12315,0,12305,10,2022-09-09
962682,충청남도,3133,0,3117,16,2022-09-09
519202,울산광역시,802,0,802,0,2022-09-10
694146,대전광역시,1481,0,1470,11,2022-09-10
1379595,인천광역시,2301,0,2223,78,2022-09-10
187226,세종특별자치시,414,0,411,3,2022-09-10
4685610,서울특별시,6081,0,6076,5,2022-09-10
1435787,부산광역시,1612,0,1603,9,2022-09-10
799186,전라남도,1484,0,1476,8,2022-09-10
328003,제주특별자치도,375,0,372,3,2022-09-10
1036910,대구광역시,2585,0,2580,5,2022-09-10
811952,전라북도,1848,0,1841,7,2022-09-10
6436806,경기도,10956,0,10947,9,2022-09-10
964656,충청남도,1974,0,1964,10,2022-09-10
748194,충청북도,1836,0,1816,20,2022-09-10
1449378,경상남도,1818,0,1800,18,2022-09-11
800294,전라남도,1108,0,1102,6,2022-09-11
710339,광주광역시,869,0,862,7,2022-09-11
1038240,대구광역시,1330,0,1325,5,2022-09-11
519655,울산광역시,453,0,451,2,2022-09-11
701564,강원도,975,0,971,4,2022-09-11
6443875,경기도,7069,0,7060,9,2022-09-11
695149,대전광역시,1003,0,994,9,2022-09-11
813215,전라북도,1263,0,1252,11,2022-09-11
1436974,부산광역시,1187,0,1183,4,2022-09-11
187514,세종특별자치시,288,0,287,1,2022-09-11
696424,대전광역시,1275,0,1264,11,2022-09-12
4696706,서울특별시,6289,0,6284,5,2022-09-12
1082247,경상북도,1878,0,1870,8,2022-09-12
6453958,경기도,10083,0,10070,13,2022-09-12
750673,충청북도,1362,0,1353,9,2022-09-12
1383494,인천광역시,2223,0,2163,60,2022-09-12
814787,전라북도,1572,0,1566,6,2022-09-12
1040054,대구광역시,1814,0,1810,4,2022-09-12
801600,전라남도,1306,0,1304,2,2022-09-12
967635,충청남도,1710,0,1696,14,2022-09-12
1451815,경상남도,2437,0,2426,11,2022-09-12
1438519,부산광역시,1545,0,1541,4,2022-09-12
520230,울산광역시,575,0,574,1,2022-09-12
187935,세종특별자치시,421,0,417,4,2022-09-12
702797,강원도,1233,0,1232,1,2022-09-12
521224,울산광역시,994,0,994,0,2022-09-13
1455593,경상남도,3778,0,3767,11,2022-09-13
6469436,경기도,15478,0,15463,15,2022-09-13
328920,제주특별자치도,307,0,304,3,2022-09-13
803409,전라남도,1809,0,1808,1,2022-09-13
4706258,서울특별시,9552,0,9546,6,2022-09-13
698457,대전광역시,2033,0,2020,13,2022-09-13
1043520,대구광역시,3466,0,3459,7,2022-09-13
712558,광주광역시,1336,0,1329,7,2022-09-13
1085055,경상북도,2808,0,2788,20,2022-09-13
704461,강원도,1664,0,1662,2,2022-09-13
752626,충청북도,1953,0,1946,7,2022-09-13
188502,세종특별자치시,567,0,558,9,2022-09-13
816955,전라북도,2168,0,2157,11,2022-09-13
970364,충청남도,2729,0,2716,13,2022-09-13
522861,울산광역시,1637,0,1629,8,2022-09-14
1461477,경상남도,5884,0,5867,17,2022-09-14
707376,강원도,2917,0,2916,1,2022-09-14
715090,광주광역시,2532,0,2519,13,2022-09-14
1392441,인천광역시,5548,0,5476,72,2022-09-14
820183,전라북도,3232,0,3218,14,2022-09-14
1446689,부산광역시,4982,0,4975,7,2022-09-14
1089380,경상북도,4329,0,4306,23,2022-09-14
329390,제주특별자치도,470,0,466,4,2022-09-14
701532,대전광역시,3075,0,3047,28,2022-09-14
189931,세종특별자치시,587,0,584,3,2022-09-15
808312,전라남도,2166,0,2156,10,2022-09-15
1466111,경상남도,4637,0,4612,25,2022-09-15
6514447,경기도,18903,0,18856,47,2022-09-15
977226,충청남도,3157,0,3134,23,2022-09-15
822930,전라북도,2749,0,2737,12,2022-09-15
4735448,서울특별시,11819,0,11808,11,2022-09-15
1052577,대구광역시,3699,0,3691,8,2022-09-15
710013,강원도,2637,0,2625,12,2022-09-15
524195,울산광역시,1334,0,1329,5,2022-09-15
1094152,경상북도,4774,0,4762,12,2022-09-15
1450032,부산광역시,3347,0,3340,7,2022-09-15
758483,충청북도,2692,0,2673,19,2022-09-15
717263,광주광역시,2174,0,2167,7,2022-09-15
824833,전라북도,1903,0,1886,17,2022-09-16
809994,전라남도,1686,0,1671,15,2022-09-16
1452531,부산광역시,2501,0,2491,10,2022-09-16
330280,제주특별자치도,350,0,338,12,2022-09-16
979361,충청남도,2135,0,2113,22,2022-09-16
711795,강원도,1782,0,1770,12,2022-09-16
190365,세종특별자치시,436,0,432,4,2022-09-16
718735,광주광역시,1472,0,1463,9,2022-09-16
1055528,대구광역시,2955,0,2940,15,2022-09-16
1469228,경상남도,3118,0,3097,21,2022-09-16
525131,울산광역시,937,0,935,2,2022-09-16
705076,대전광역시,1604,0,1587,17,2022-09-16
1099697,경상북도,2515,0,2499,16,2022-09-17
6539886,경기도,11609,0,11572,37,2022-09-17
1471848,경상남도,2620,0,2590,30,2022-09-17
1402430,인천광역시,2606,0,2528,78,2022-09-17
761759,충청북도,1553,0,1537,16,2022-09-17
4752318,서울특별시,7659,0,7653,6,2022-09-17
811398,전라남도,1405,0,1401,4,2022-09-17
719967,광주광역시,1232,0,1222,10,2022-09-17
1454608,부산광역시,2080,0,2075,5,2022-09-17
190691,세종특별자치시,327,0,326,1,2022-09-17
713285,강원도,1490,0,1479,11,2022-09-17
981198,충청남도,1847,0,1839,8,2022-09-17
526503,울산광역시,654,0,650,4,2022-09-18
1456201,부산광역시,1593,0,1586,7,2022-09-18
4758288,서울특별시,5970,0,5968,2,2022-09-18
1474098,경상남도,2250,0,2231,19,2022-09-18
714368,강원도,1083,0,1075,8,2022-09-18
812477,전라남도,1079,0,1067,12,2022-09-18
721075,광주광역시,1108,0,1101,7,2022-09-18
763012,충청북도,1253,0,1246,7,2022-09-18
1404516,인천광역시,2086,0,2026,60,2022-09-18
190981,세종특별자치시,290,0,286,4,2022-09-18
330902,제주특별자치도,270,0,263,7,2022-09-18
707343,대전광역시,1004,0,995,9,2022-09-18
1102955,경상북도,1084,0,1063,21,2022-09-19
4761487,서울특별시,3199,0,3192,7,2022-09-19
1060968,대구광역시,942,0,939,3,2022-09-19
721625,광주광역시,550,0,547,3,2022-09-19
6554660,경기도,5756,0,5752,4,2022-09-19
715017,강원도,649,0,648,1,2022-09-19
707949,대전광역시,606,0,597,9,2022-09-19
763692,충청북도,680,0,674,6,2022-09-19
813064,전라남도,587,0,586,1,2022-09-19
1405904,인천광역시,1388,0,1256,132,2022-09-19
1475124,경상남도,1026,0,1011,15,2022-09-19
828474,전라북도,605,0,592,13,2022-09-19
1456840,부산광역시,639,0,633,6,2022-09-19
722686,광주광역시,1061,0,1056,5,2022-09-20
191609,세종특별자치시,420,0,418,2,2022-09-20
1063578,대구광역시,2612,0,2602,10,2022-09-20
4771203,서울특별시,9735,0,9726,9,2022-09-20
765103,충청북도,1416,0,1404,12,2022-09-20
6567961,경기도,13316,0,13288,28,2022-09-20
527473,울산광역시,678,0,676,2,2022-09-20
1105034,경상북도,2080,0,2058,22,2022-09-20
985647,충청남도,2021,0,2005,16,2022-09-20
1408985,인천광역시,3084,0,2977,107,2022-09-20
1459247,부산광역시,2407,0,2402,5,2022-09-20
6579549,경기도,11604,0,11548,56,2022-09-21
1480290,경상남도,2301,0,2280,21,2022-09-21
987348,충청남도,1701,0,1691,10,2022-09-21
1107571,경상북도,2537,0,2520,17,2022-09-21
723985,광주광역시,1299,0,1290,9,2022-09-21
4778549,서울특별시,7358,0,7349,9,2022-09-21
1411461,인천광역시,2496,0,2422,74,2022-09-21
331747,제주특별자치도,354,0,344,10,2022-09-21
191928,세종특별자치시,319,0,317,2,2022-09-21
815636,전라남도,1165,0,1160,5,2022-09-21
831592,전라북도,1498,0,1486,12,2022-09-21
717757,강원도,1344,0,1334,10,2022-09-21
1461048,부산광역시,1802,0,1794,8,2022-09-21
766559,충청북도,1456,0,1429,27,2022-09-21
724883,광주광역시,898,0,889,9,2022-09-22
988701,충청남도,1363,0,1350,13,2022-09-22
1067537,대구광역시,1828,0,1823,5,2022-09-22
1482273,경상남도,1983,0,1973,10,2022-09-22
4784699,서울특별시,6154,0,6145,9,2022-09-22
1413525,인천광역시,2070,0,1981,89,2022-09-22
718774,강원도,1017,0,1011,6,2022-09-22
711571,대전광역시,954,0,945,9,2022-09-22
1109323,경상북도,1752,0,1732,20,2022-09-22
192179,세종특별자치시,251,0,245,6,2022-09-22
832671,전라북도,1082,0,1075,7,2022-09-22
332011,제주특별자치도,265,0,262,3,2022-09-22
528743,울산광역시,534,0,529,5,2022-09-22
6588622,경기도,9084,0,9057,27,2022-09-22
1462569,부산광역시,1522,0,1516,6,2022-09-22
816710,전라남도,1074,0,1074,0,2022-09-22
817583,전라남도,874,0,872,2,2022-09-23
1463843,부산광역시,1276,0,1264,12,2022-09-23
719717,강원도,943,0,934,9,2022-09-23
768692,충청북도,978,0,968,10,2022-09-23
4790319,서울특별시,5625,0,5609,16,2022-09-23
1415296,인천광역시,1777,0,1715,62,2022-09-23
833668,전라북도,999,0,974,25,2022-09-23
529203,울산광역시,461,0,459,2,2022-09-23
989910,충청남도,1209,0,1196,13,2022-09-23
1068973,대구광역시,1436,0,1427,9,2022-09-23
712375,대전광역시,804,0,799,5,2022-09-23
769673,충청북도,981,0,960,21,2022-09-24
726405,광주광역시,746,0,742,4,2022-09-24
332484,제주특별자치도,267,0,265,2,2022-09-24
6604934,경기도,8135,0,8104,31,2022-09-24
720587,강원도,870,0,859,11,2022-09-24
192666,세종특별자치시,231,0,227,4,2022-09-24
1417074,인천광역시,1785,0,1691,94,2022-09-24
1465101,부산광역시,1259,0,1254,5,2022-09-24
991170,충청남도,1270,0,1250,20,2022-09-24
818473,전라남도,890,0,887,3,2022-09-24
713190,대전광역시,815,0,808,7,2022-09-24
1070564,대구광역시,1592,0,1584,8,2022-09-24
834615,전라북도,950,0,931,19,2022-09-24
819220,전라남도,747,0,743,4,2022-09-25
4800846,서울특별시,4888,0,4884,4,2022-09-25
6612022,경기도,7088,0,7068,20,2022-09-25
1114169,경상북도,1573,0,1553,20,2022-09-25
770579,충청북도,906,0,893,13,2022-09-25
1487217,경상남도,1535,0,1521,14,2022-09-25
713913,대전광역시,723,0,712,11,2022-09-25
1071821,대구광역시,1257,0,1253,4,2022-09-25
721295,강원도,708,0,701,7,2022-09-25
530116,울산광역시,451,0,446,5,2022-09-25
835547,전라북도,932,0,921,11,2022-09-25
992224,충청남도,1054,0,1050,4,2022-09-25
1468617,부산광역시,1889,0,1880,9,2022-09-27
1116603,경상북도,1648,0,1637,11,2022-09-27
994348,충청남도,1543,0,1535,8,2022-09-27
1422196,인천광역시,2489,0,2381,108,2022-09-27
193327,세종특별자치시,332,0,332,0,2022-09-27
715451,대전광역시,1132,0,1119,13,2022-09-27
1490170,경상남도,2214,0,2197,17,2022-09-27
837107,전라북도,1111,0,1102,9,2022-09-27
723001,강원도,1167,0,1160,7,2022-09-27
772205,충청북도,1155,0,1147,8,2022-09-27
6627542,경기도,11384,0,11352,32,2022-09-27
530892,울산광역시,565,0,562,3,2022-09-27
4818845,서울특별시,7122,0,7109,13,2022-09-28
729361,광주광역시,1020,0,1004,16,2022-09-28
1492110,경상남도,1940,0,1900,40,2022-09-28
1076383,대구광역시,1667,0,1652,15,2022-09-28
773407,충청북도,1202,0,1190,12,2022-09-28
1470238,부산광역시,1621,0,1614,7,2022-09-28
333255,제주특별자치도,235,0,228,7,2022-09-28
6637835,경기도,10297,0,10267,30,2022-09-28
838286,전라북도,1180,0,1144,36,2022-09-28
716465,대전광역시,1014,0,992,22,2022-09-28
821777,전라남도,999,0,991,8,2022-09-28
193626,세종특별자치시,299,0,290,9,2022-09-28
725393,강원도,1080,0,1067,13,2022-09-29
730107,광주광역시,747,0,744,3,2022-09-29
717281,대전광역시,816,0,806,10,2022-09-29
774396,충청북도,990,0,980,10,2022-09-29
532013,울산광역시,498,0,496,2,2022-09-29
1493850,경상남도,1740,0,1728,12,2022-09-29
1077835,대구광역시,1452,0,1450,2,2022-09-29
333506,제주특별자치도,251,0,248,3,2022-09-29
1426134,인천광역시,1863,0,1789,74,2022-09-29
193859,세종특별자치시,233,0,232,1,2022-09-29
6646658,경기도,8830,0,8804,26,2022-09-29
997061,충청남도,1239,0,1231,8,2022-09-29
839274,전라북도,988,0,963,25,2022-09-29
822684,전라남도,909,0,906,3,2022-09-29
726316,강원도,923,0,920,3,2022-09-30
1495375,경상남도,1525,0,1508,17,2022-09-30
775343,충청북도,947,0,939,8,2022-09-30
998101,충청남도,1040,0,1032,8,2022-09-30
333724,제주특별자치도,218,0,215,3,2022-09-30
532497,울산광역시,486,0,480,6,2022-09-30
1472920,부산광역시,1267,0,1264,3,2022-09-30
1121622,경상북도,1452,0,1443,9,2022-09-30
840166,전라북도,892,0,861,31,2022-09-30
1079431,대구광역시,1598,0,1584,14,2022-09-30
823497,전라남도,813,0,805,8,2022-09-30
718013,대전광역시,732,0,720,12,2022-09-30
1080682,대구광역시,1251,0,1247,4,2022-10-01
718761,대전광역시,751,0,736,15,2022-10-01
999137,충청남도,1045,0,1034,11,2022-10-01
333931,제주특별자치도,208,0,202,6,2022-10-01
6662647,경기도,7837,0,7782,55,2022-10-01
532949,울산광역시,454,0,450,4,2022-10-01
1429434,인천광역시,1570,0,1504,66,2022-10-01
4836468,서울특별시,5584,0,5575,9,2022-10-01
731376,광주광역시,618,0,615,3,2022-10-01
194298,세종특별자치시,222,0,220,2,2022-10-01
824216,전라남도,720,0,707,13,2022-10-01
1496904,경상남도,1531,0,1515,16,2022-10-01
1474236,부산광역시,1317,0,1309,8,2022-10-01
840961,전라북도,795,0,776,19,2022-10-01
1122921,경상북도,1299,0,1281,18,2022-10-01
1475256,부산광역시,1020,0,1016,4,2022-10-02
824902,전라남도,686,0,683,3,2022-10-02
731961,광주광역시,585,0,577,8,2022-10-02
841733,전라북도,772,0,759,13,2022-10-02
1498268,경상남도,1364,0,1343,21,2022-10-02
194509,세종특별자치시,211,0,209,2,2022-10-02
1000115,충청남도,978,0,968,10,2022-10-02
719367,대전광역시,606,0,603,3,2022-10-02
6669488,경기도,6841,0,6812,29,2022-10-02
533414,울산광역시,465,0,461,4,2022-10-02
776957,충청북도,791,0,778,13,2022-10-02
1124174,경상북도,1253,0,1239,14,2022-10-02
1081699,대구광역시,1017,0,1011,6,2022-10-02
4841265,서울특별시,4797,0,4783,14,2022-10-02
4843290,서울특별시,2025,0,2023,2,2022-10-03
732211,광주광역시,250,0,236,14,2022-10-03
1124895,경상북도,721,0,717,4,2022-10-03
1082471,대구광역시,772,0,770,2,2022-10-03
728352,강원도,456,0,454,2,2022-10-03
1498960,경상남도,692,0,676,16,2022-10-03
825179,전라남도,277,0,275,2,2022-10-03
334244,제주특별자치도,142,0,136,6,2022-10-03
825606,전라남도,427,0,427,0,2022-10-04
720172,대전광역시,468,0,467,1,2022-10-04
728893,강원도,541,0,539,2,2022-10-04
1125804,경상북도,909,0,901,8,2022-10-04
6678061,경기도,4792,0,4785,7,2022-10-04
777839,충청북도,499,0,498,1,2022-10-04
4846376,서울특별시,3086,0,3084,2,2022-10-04
1001249,충청남도,666,0,664,2,2022-10-04
1432450,인천광역시,888,0,882,6,2022-10-04
1083359,대구광역시,888,0,884,4,2022-10-04
732534,광주광역시,323,0,317,6,2022-10-04
826504,전라남도,898,0,898,0,2022-10-05
195078,세종특별자치시,274,0,273,1,2022-10-05
843516,전라북도,976,0,973,3,2022-10-05
334578,제주특별자치도,190,0,189,1,2022-10-05
1501879,경상남도,1946,0,1939,7,2022-10-05
778927,충청북도,1088,0,1087,1,2022-10-05
1434540,인천광역시,2095,0,2087,8,2022-10-05
721087,대전광역시,915,0,911,4,2022-10-05
1478179,부산광역시,1799,0,1797,2,2022-10-05
1084955,대구광역시,1596,0,1592,4,2022-10-05
733269,광주광역시,735,0,735,0,2022-10-05
730116,강원도,1224,0,1223,1,2022-10-05
1127408,경상북도,1604,0,1598,6,2022-10-05
1479493,부산광역시,1316,0,1313,3,2022-10-06
1503445,경상남도,1567,0,1564,3,2022-10-06
844441,전라북도,928,0,925,3,2022-10-06
1003623,충청남도,1051,0,1050,1,2022-10-06
1086563,대구광역시,1608,0,1603,5,2022-10-06
1129308,경상북도,1900,0,1893,7,2022-10-06
535080,울산광역시,579,0,578,1,2022-10-06
195299,세종특별자치시,221,0,219,2,2022-10-06
827193,전라남도,692,0,692,0,2022-10-06
6695672,경기도,7790,0,7779,11,2022-10-06
1436130,인천광역시,1603,0,1601,2,2022-10-06
779965,충청북도,1039,0,1039,0,2022-10-06
4859554,서울특별시,5520,0,5519,1,2022-10-06
722427,대전광역시,598,0,592,6,2022-10-07
732041,강원도,800,0,799,1,2022-10-07
1004428,충청남도,805,0,804,1,2022-10-07
827758,전라남도,566,0,565,1,2022-10-07
1088032,대구광역시,1470,0,1467,3,2022-10-07
195473,세종특별자치시,174,0,174,0,2022-10-07
1504672,경상남도,1227,0,1224,3,2022-10-07
6701806,경기도,6154,0,6145,9,2022-10-07
4863862,서울특별시,4319,0,4319,0,2022-10-07
1437430,인천광역시,1300,0,1298,2,2022-10-07
780742,충청북도,777,0,776,1,2022-10-07
1480545,부산광역시,1053,0,1053,0,2022-10-07
1505729,경상남도,1057,0,1055,2,2022-10-08
4867800,서울특별시,3963,0,3962,1,2022-10-08
722931,대전광역시,504,0,502,2,2022-10-08
781410,충청북도,668,0,666,2,2022-10-08
1438488,인천광역시,1062,0,1060,2,2022-10-08
1481491,부산광역시,949,0,948,1,2022-10-08
335170,제주특별자치도,156,0,155,1,2022-10-08
732731,강원도,690,0,690,0,2022-10-08
1089050,대구광역시,1018,0,1016,2,2022-10-08
723394,대전광역시,463,0,459,4,2022-10-09
828752,전라남도,492,0,491,1,2022-10-09
1482375,부산광역시,884,0,884,0,2022-10-09
733273,강원도,542,0,540,2,2022-10-09
1506836,경상남도,1107,0,1107,0,2022-10-09
4871352,서울특별시,3552,0,3551,1,2022-10-09
1090014,대구광역시,964,0,962,2,2022-10-09
1439470,인천광역시,982,0,974,8,2022-10-09
782049,충청북도,639,0,636,3,2022-10-09
1005873,충청남도,700,0,700,0,2022-10-09
6711799,경기도,4672,0,4667,5,2022-10-09
846369,전라북도,578,0,578,0,2022-10-09
1132738,경상북도,1038,0,1030,8,2022-10-09
335320,제주특별자치도,150,0,150,0,2022-10-09
536296,울산광역시,187,0,186,1,2022-10-10
1006200,충청남도,327,0,327,0,2022-10-10
335399,제주특별자치도,79,0,79,0,2022-10-10
723669,대전광역시,275,0,273,2,2022-10-10
733691,강원도,418,0,418,0,2022-10-10
4872846,서울특별시,1494,0,1493,1,2022-10-10
1440040,인천광역시,570,0,569,1,2022-10-10
829009,전라남도,257,0,257,0,2022-10-10
735598,광주광역시,233,0,233,0,2022-10-10
1507245,경상남도,409,0,409,0,2022-10-10
1133281,경상북도,543,0,543,0,2022-10-10
1482692,부산광역시,317,0,316,1,2022-10-10
6714432,경기도,2633,0,2632,1,2022-10-10
1508160,경상남도,915,0,915,0,2022-10-11
1006836,충청남도,636,0,636,0,2022-10-11
734172,강원도,481,0,480,1,2022-10-11
195975,세종특별자치시,143,0,141,2,2022-10-11
1091055,대구광역시,567,0,564,3,2022-10-11
1442851,인천광역시,1871,0,1870,1,2022-10-12
335701,제주특별자치도,179,0,178,1,2022-10-12
196215,세종특별자치시,240,0,237,3,2022-10-12
6727323,경기도,8500,0,8484,16,2022-10-12
848040,전라북도,882,0,879,3,2022-10-12
4882697,서울특별시,6802,0,6801,1,2022-10-12
736483,광주광역시,547,0,545,2,2022-10-12
735203,강원도,1032,0,1030,2,2022-10-12
1485171,부산광역시,1693,0,1692,1,2022-10-12
830207,전라남도,732,0,729,3,2022-10-12
783859,충청북도,944,0,944,0,2022-10-12
1135495,경상북도,1483,0,1481,2,2022-10-12
1092687,대구광역시,1632,0,1630,2,2022-10-12
537180,울산광역시,542,0,541,1,2022-10-12
830856,전라남도,649,0,648,1,2022-10-13
1093937,대구광역시,1250,0,1245,5,2022-10-13
1511120,경상남도,1416,0,1415,1,2022-10-13
537717,울산광역시,537,0,537,0,2022-10-13
736274,강원도,1072,0,1071,1,2022-10-13
1008824,충청남도,967,0,967,0,2022-10-13
725722,대전광역시,728,0,723,5,2022-10-13
335972,제주특별자치도,271,0,268,3,2022-10-13
737173,광주광역시,691,0,691,0,2022-10-13
1486374,부산광역시,1206,0,1203,3,2022-10-13
196443,세종특별자치시,230,0,229,1,2022-10-13
6734758,경기도,7443,0,7433,10,2022-10-13
1137195,경상북도,1700,0,1693,7,2022-10-13
1009718,충청남도,894,0,893,1,2022-10-14
336121,제주특별자치도,149,0,148,1,2022-10-14
4892777,서울특별시,4834,0,4831,3,2022-10-14
6741347,경기도,6597,0,6589,8,2022-10-14
538205,울산광역시,488,0,485,3,2022-10-14
726457,대전광역시,735,0,731,4,2022-10-14
737689,광주광역시,516,0,514,2,2022-10-14
785675,충청북도,778,0,775,3,2022-10-14
831504,전라남도,649,0,647,2,2022-10-14
1512309,경상남도,1190,0,1190,0,2022-10-14
1094906,대구광역시,969,0,966,3,2022-10-14
737175,강원도,902,0,900,2,2022-10-14
196614,세종특별자치시,172,0,171,1,2022-10-14
832108,전라남도,604,0,603,1,2022-10-15
1513401,경상남도,1092,0,1092,0,2022-10-15
538667,울산광역시,462,0,458,4,2022-10-15
850243,전라북도,677,0,675,2,2022-10-15
1139978,경상북도,1324,0,1324,0,2022-10-15
1096015,대구광역시,1109,0,1108,1,2022-10-15
738235,광주광역시,546,0,546,0,2022-10-15
786449,충청북도,774,0,772,2,2022-10-15
6747719,경기도,6434,0,6431,3,2022-10-15
727154,대전광역시,701,0,696,5,2022-10-15
737979,강원도,804,0,804,0,2022-10-15
1010480,충청남도,772,0,770,2,2022-10-15
1447312,인천광역시,1395,0,1390,5,2022-10-15
196985,세종특별자치시,192,0,190,2,2022-10-16
1011325,충청남도,845,0,845,0,2022-10-16
787098,충청북도,649,0,647,2,2022-10-16
727781,대전광역시,627,0,618,9,2022-10-16
539107,울산광역시,440,0,437,3,2022-10-16
336471,제주특별자치도,160,0,159,1,2022-10-16
1097068,대구광역시,1053,0,1050,3,2022-10-16
4901542,서울특별시,4191,0,4190,1,2022-10-16
1489655,부산광역시,993,0,993,0,2022-10-16
850916,전라북도,673,0,672,1,2022-10-16
832653,전라남도,545,0,545,0,2022-10-16
6753813,경기도,6094,0,6091,3,2022-10-16
1141312,경상북도,1334,0,1330,4,2022-10-16
728131,대전광역시,350,0,346,4,2022-10-17
6757182,경기도,3369,0,3363,6,2022-10-17
1490063,부산광역시,408,0,406,2,2022-10-17
1141958,경상북도,646,0,642,4,2022-10-17
787410,충청북도,312,0,312,0,2022-10-17
851238,전라북도,322,0,322,0,2022-10-17
197083,세종특별자치시,98,0,97,1,2022-10-17
1449317,인천광역시,718,0,715,3,2022-10-17
1097533,대구광역시,465,0,463,2,2022-10-17
1515010,경상남도,572,0,570,2,2022-10-17
1491845,부산광역시,1783,0,1782,1,2022-10-18
1451484,인천광역시,2182,0,2178,4,2022-10-18
1098993,대구광역시,1461,0,1454,7,2022-10-18
739733,광주광역시,674,0,672,2,2022-10-18
197331,세종특별자치시,248,0,247,1,2022-10-18
6766636,경기도,9468,0,9452,16,2022-10-18
740284,강원도,1071,0,1070,1,2022-10-18
539935,울산광역시,617,0,616,1,2022-10-18
4910983,서울특별시,7531,0,7527,4,2022-10-18
1143462,경상북도,1504,0,1504,0,2022-10-18
788346,충청북도,936,0,933,3,2022-10-18
1518059,경상남도,1440,0,1440,0,2022-10-19
853018,전라북도,886,0,885,1,2022-10-19
729944,대전광역시,827,0,822,5,2022-10-19
1453297,인천광역시,1815,0,1813,2,2022-10-19
1145289,경상북도,1827,0,1824,3,2022-10-19
1014081,충청남도,1062,0,1060,2,2022-10-19
1100354,대구광역시,1361,0,1359,2,2022-10-19
336952,제주특별자치도,175,0,175,0,2022-10-19
6775100,경기도,8474,0,8458,16,2022-10-19
789282,충청북도,936,0,934,2,2022-10-19
741528,강원도,1244,0,1244,0,2022-10-19
1493256,부산광역시,1412,0,1409,3,2022-10-19
197539,세종특별자치시,208,0,208,0,2022-10-19
540508,울산광역시,575,0,572,3,2022-10-19
4916878,서울특별시,5897,0,5888,9,2022-10-19
1454840,인천광역시,1543,0,1543,0,2022-10-20
741079,광주광역시,670,0,669,1,2022-10-20
853726,전라북도,708,0,707,1,2022-10-20
197714,세종특별자치시,175,0,170,5,2022-10-20
4922285,서울특별시,5416,0,5416,0,2022-10-20
834997,전라남도,602,0,601,1,2022-10-20
790011,충청북도,731,0,729,2,2022-10-20
1146840,경상북도,1551,0,1548,3,2022-10-20
6782366,경기도,7302,0,7300,2,2022-10-20
337094,제주특별자치도,142,0,142,0,2022-10-20
742536,강원도,1009,0,1008,1,2022-10-20
1519178,경상남도,1121,0,1120,1,2022-10-20
1015021,충청남도,950,0,949,1,2022-10-20
1148211,경상북도,1372,0,1371,1,2022-10-21
197884,세종특별자치시,170,0,169,1,2022-10-21
1456437,인천광역시,1598,0,1596,2,2022-10-21
337256,제주특별자치도,162,0,162,0,2022-10-21
741647,광주광역시,568,0,566,2,2022-10-21
1520293,경상남도,1115,0,1112,3,2022-10-21
4927337,서울특별시,5061,0,5057,4,2022-10-21
541464,울산광역시,450,0,448,2,2022-10-21
6789443,경기도,7085,0,7080,5,2022-10-21
731476,대전광역시,771,0,767,4,2022-10-21
1015938,충청남도,917,0,915,2,2022-10-21
1102714,대구광역시,1245,0,1243,2,2022-10-21
791520,충청북도,740,0,740,0,2022-10-22
6797448,경기도,8055,0,8046,9,2022-10-22
1016839,충청남도,911,0,910,1,2022-10-22
1458130,인천광역시,1698,0,1692,6,2022-10-22
1103716,대구광역시,1002,0,1002,0,2022-10-22
836245,전라남도,677,0,676,1,2022-10-22
541916,울산광역시,452,0,451,1,2022-10-22
855166,전라북도,735,0,733,2,2022-10-22
198077,세종특별자치시,193,0,193,0,2022-10-22
744438,강원도,960,0,956,4,2022-10-22
1149613,경상북도,1402,0,1402,0,2022-10-22
1521515,경상남도,1222,0,1220,2,2022-10-22
4933342,서울특별시,6016,0,6015,1,2022-10-22
337423,제주특별자치도,167,0,165,2,2022-10-22
1017861,충청남도,1022,0,1021,1,2022-10-23
1497967,부산광역시,1193,0,1193,0,2022-10-23
6805048,경기도,7600,0,7595,5,2022-10-23
198296,세종특별자치시,219,0,219,0,2022-10-23
337589,제주특별자치도,166,0,164,2,2022-10-23
742893,광주광역시,611,0,610,1,2022-10-23
856021,전라북도,855,0,852,3,2022-10-23
792231,충청북도,711,0,710,1,2022-10-23
542450,울산광역시,534,0,534,0,2022-10-23
1104921,대구광역시,1205,0,1205,0,2022-10-23
745272,강원도,834,0,830,4,2022-10-23
836902,전라남도,657,0,657,0,2022-10-23
1151228,경상북도,1615,0,1612,3,2022-10-23
4938518,서울특별시,5176,0,5175,1,2022-10-23
733167,대전광역시,883,0,878,5,2022-10-23
337736,제주특별자치도,147,0,147,0,2022-10-24
837267,전라남도,365,0,363,2,2022-10-24
1152090,경상북도,862,0,861,1,2022-10-24
542743,울산광역시,293,0,293,0,2022-10-24
6809645,경기도,4597,0,4596,1,2022-10-24
792745,충청북도,514,0,514,0,2022-10-24
1460727,인천광역시,937,0,930,7,2022-10-24
745835,강원도,563,0,563,0,2022-10-24
1523443,경상남도,645,0,641,4,2022-10-24
1105476,대구광역시,555,0,555,0,2022-10-24
1498462,부산광역시,495,0,493,2,2022-10-24
856383,전라북도,362,0,360,2,2022-10-24
4940956,서울특별시,2438,0,2435,3,2022-10-24
1018435,충청남도,574,0,571,3,2022-10-24
1020073,충청남도,1647,0,1647,0,2022-10-25
857427,전라북도,1046,0,1044,2,2022-10-25
794114,충청북도,1369,0,1368,1,2022-10-25
198867,세종특별자치시,439,0,437,2,2022-10-25
6822522,경기도,12888,0,12874,14,2022-10-25
744080,광주광역시,843,0,841,2,2022-10-25
4951008,서울특별시,10066,0,10059,7,2022-10-25
1153982,경상북도,1893,0,1891,2,2022-10-25
1463367,인천광역시,2641,0,2639,2,2022-10-25
747177,강원도,1344,0,1340,4,2022-10-25
1500772,부산광역시,2310,0,2310,0,2022-10-25
543513,울산광역시,771,0,770,1,2022-10-25
1525475,경상남도,2032,0,2031,1,2022-10-25
337877,제주특별자치도,141,0,139,2,2022-10-25
1109260,대구광역시,1957,0,1952,5,2022-10-26
748834,강원도,1657,0,1651,6,2022-10-26
839260,전라남도,965,0,964,1,2022-10-26
6834532,경기도,12023,0,12019,4,2022-10-26
199230,세종특별자치시,363,0,363,0,2022-10-26
338157,제주특별자치도,280,0,279,1,2022-10-26
1465901,인천광역시,2534,0,2529,5,2022-10-26
858630,전라북도,1205,0,1199,6,2022-10-26
795432,충청북도,1318,0,1317,1,2022-10-26
1502623,부산광역시,1855,0,1853,2,2022-10-26
544305,울산광역시,792,0,790,2,2022-10-26
1156351,경상북도,2369,0,2362,7,2022-10-26
1158321,경상북도,1970,0,1968,2,2022-10-27
1110814,대구광역시,1556,0,1552,4,2022-10-27
4965729,서울특별시,6848,0,6845,3,2022-10-27
545031,울산광역시,726,0,725,1,2022-10-27
6844793,경기도,10264,0,10260,4,2022-10-27
840072,전라남도,813,0,812,1,2022-10-27
750134,강원도,1300,0,1295,5,2022-10-27
1529013,경상남도,1654,0,1653,1,2022-10-27
1468117,인천광역시,2218,0,2216,2,2022-10-27
1504366,부산광역시,1745,0,1745,0,2022-10-27
745947,광주광역시,895,0,892,3,2022-10-27
199881,세종특별자치시,309,0,308,1,2022-10-28
1530671,경상남도,1664,0,1662,2,2022-10-28
1024341,충청남도,1406,0,1406,0,2022-10-28
1470431,인천광역시,2317,0,2317,0,2022-10-28
1112417,대구광역시,1604,0,1600,4,2022-10-28
4973197,서울특별시,7480,0,7476,4,2022-10-28
746752,광주광역시,805,0,804,1,2022-10-28
1160153,경상북도,1833,0,1833,0,2022-10-28
797644,충청북도,1137,0,1136,1,2022-10-28
840915,전라남도,846,0,842,4,2022-10-28
545735,울산광역시,704,0,703,1,2022-10-28
338552,제주특별자치도,217,0,214,3,2022-10-28
1506040,부산광역시,1677,0,1677,0,2022-10-28
1114098,대구광역시,1681,0,1678,3,2022-10-29
1507932,부산광역시,1893,0,1891,2,2022-10-29
1025756,충청남도,1425,0,1424,1,2022-10-29
200182,세종특별자치시,301,0,300,1,2022-10-29
861675,전라북도,1028,0,1024,4,2022-10-29
338761,제주특별자치도,209,0,209,0,2022-10-29
841854,전라남도,940,0,936,4,2022-10-29
1161992,경상북도,1839,0,1839,0,2022-10-29
6866233,경기도,10999,0,10995,4,2022-10-29
798852,충청북도,1209,0,1209,0,2022-10-29
546498,울산광역시,764,0,763,1,2022-10-29
739517,대전광역시,1186,0,1179,7,2022-10-29
748512,광주광역시,886,0,885,1,2022-10-30
1533890,경상남도,1553,0,1551,2,2022-10-30
200511,세종특별자치시,329,0,328,1,2022-10-30
4987483,서울특별시,6708,0,6707,1,2022-10-30
338989,제주특별자치도,228,0,228,0,2022-10-30
842715,전라남도,861,0,861,0,2022-10-30
1164041,경상북도,2049,0,2049,0,2022-10-30
1027152,충청남도,1396,0,1392,4,2022-10-30
1474963,인천광역시,2209,0,2209,0,2022-10-30
1509493,부산광역시,1561,0,1561,0,2022-10-30
800139,충청북도,1287,0,1286,1,2022-10-30
1115802,대구광역시,1704,0,1703,1,2022-10-30
862753,전라북도,1078,0,1078,0,2022-10-30
754181,강원도,1273,0,1270,3,2022-10-30
842715,전라남도,861,0,861,0,2022-10-31
1027152,충청남도,1396,0,1392,4,2022-10-31
338989,제주특별자치도,228,0,228,0,2022-10-31
1164041,경상북도,2049,0,2049,0,2022-10-31
862753,전라북도,1078,0,1078,0,2022-10-31
800139,충청북도,1287,0,1286,1,2022-10-31
754181,강원도,1273,0,1270,3,2022-10-31
843239,전라남도,524,0,524,0,2022-10-31
1027947,충청남도,795,0,795,0,2022-10-31
740552,대전광역시,1035,0,1033,2,2022-10-31
1474963,인천광역시,2209,0,2209,0,2022-10-31
1164949,경상북도,908,0,908,0,2022-10-31
547531,울산광역시,396,0,395,1,2022-10-31
200690,세종특별자치시,179,0,179,0,2022-10-31
1476151,인천광역시,1188,0,1185,3,2022-10-31
1509493,부산광역시,1561,0,1561,0,2022-10-31
741125,대전광역시,573,0,570,3,2022-10-31
1116532,대구광역시,730,0,729,1,2022-10-31
1533890,경상남도,1553,0,1551,2,2022-10-31
1510168,부산광역시,675,0,674,1,2022-10-31
748512,광주광역시,886,0,885,1,2022-10-31
748968,광주광역시,456,0,456,0,2022-10-31
6881862,경기도,5938,0,5933,5,2022-10-31
4990582,서울특별시,3099,0,3098,1,2022-10-31
548502,울산광역시,971,0,969,2,2022-11-01
6898910,경기도,17056,0,17045,11,2022-11-01
864901,전라북도,1557,0,1555,2,2022-11-01
844775,전라남도,1537,0,1536,1,2022-11-01
757003,강원도,1982,0,1980,2,2022-11-01
1030184,충청남도,2237,0,2237,0,2022-11-01
1513199,부산광역시,3032,0,3029,3,2022-11-01
743092,대전광역시,1967,0,1966,1,2022-11-01
201207,세종특별자치시,517,0,514,3,2022-11-01
1537284,경상남도,2608,0,2608,0,2022-11-01
1118990,대구광역시,2459,0,2458,1,2022-11-01
339375,제주특별자치도,225,0,224,1,2022-11-01
802584,충청북도,1813,0,1812,1,2022-11-01
1167475,경상북도,2526,0,2523,3,2022-11-01
866508,전라북도,1608,0,1602,6,2022-11-02
1539651,경상남도,2367,0,2364,3,2022-11-02
6914884,경기도,15980,0,15968,12,2022-11-02
201731,세종특별자치시,524,0,524,0,2022-11-02
1032395,충청남도,2211,0,2210,1,2022-11-02
804567,충청북도,1984,0,1983,1,2022-11-02
1170471,경상북도,2997,0,2993,4,2022-11-02
744743,대전광역시,1651,0,1648,3,2022-11-02
549493,울산광역시,991,0,991,0,2022-11-02
1515615,부산광역시,2423,0,2420,3,2022-11-02
846155,전라남도,1381,0,1380,1,2022-11-02
806188,충청북도,1622,0,1621,1,2022-11-03
1486072,인천광역시,2874,0,2872,2,2022-11-03
1123176,대구광역시,1767,0,1765,2,2022-11-03
6928707,경기도,13826,0,13818,8,2022-11-03
202150,세종특별자치시,419,0,419,0,2022-11-03
340015,제주특별자치도,281,0,281,0,2022-11-03
746252,대전광역시,1509,0,1508,1,2022-11-03
847218,전라남도,1063,0,1062,1,2022-11-03
1034145,충청남도,1760,0,1757,3,2022-11-03
550279,울산광역시,787,0,786,1,2022-11-03
1517831,부산광역시,2217,0,2217,0,2022-11-03
5024068,서울특별시,9547,0,9543,4,2022-11-03
752591,광주광역시,1202,0,1200,2,2022-11-03
867933,전라북도,1426,0,1423,3,2022-11-03
762733,강원도,1634,0,1632,2,2022-11-04
340279,제주특별자치도,264,0,264,0,2022-11-04
551010,울산광역시,731,0,730,1,2022-11-04
1543700,경상남도,1916,0,1914,2,2022-11-04
202546,세종특별자치시,397,0,397,0,2022-11-04
1035927,충청남도,1782,0,1782,0,2022-11-04
848278,전라남도,1061,0,1061,0,2022-11-04
1488704,인천광역시,2633,0,2626,7,2022-11-04
6941408,경기도,12709,0,12698,11,2022-11-04
5032737,서울특별시,8677,0,8677,0,2022-11-04
753637,광주광역시,1046,0,1046,0,2022-11-04
807676,충청북도,1490,0,1490,0,2022-11-04
1175444,경상북도,2361,0,2361,0,2022-11-04
1519921,부산광역시,2092,0,2090,2,2022-11-04
747643,대전광역시,1391,0,1391,0,2022-11-04
809082,충청북도,1407,0,1407,0,2022-11-05
1126926,대구광역시,1797,0,1792,5,2022-11-05
6953150,경기도,11761,0,11757,4,2022-11-05
1491109,인천광역시,2411,0,2407,4,2022-11-05
5040836,서울특별시,8104,0,8103,1,2022-11-05
749009,대전광역시,1366,0,1365,1,2022-11-05
849418,전라남도,1140,0,1138,2,2022-11-05
551754,울산광역시,745,0,745,0,2022-11-05
764288,강원도,1555,0,1554,1,2022-11-05
202912,세종특별자치시,366,0,366,0,2022-11-05
1037625,충청남도,1702,0,1702,0,2022-11-05
870449,전라북도,1227,0,1227,0,2022-11-05
1521895,부산광역시,1974,0,1972,2,2022-11-05
1177685,경상북도,2243,0,2238,5,2022-11-05
340521,제주특별자치도,242,0,240,2,2022-11-05
850338,전라남도,920,0,919,1,2022-11-06
765610,강원도,1322,0,1321,1,2022-11-06
1179847,경상북도,2162,0,2158,4,2022-11-06
750077,대전광역시,1068,0,1067,1,2022-11-06
810504,충청북도,1422,0,1419,3,2022-11-06
5047999,서울특별시,7163,0,7162,1,2022-11-06
755557,광주광역시,945,0,945,0,2022-11-06
1523543,부산광역시,1648,0,1646,2,2022-11-06
871702,전라북도,1253,0,1252,1,2022-11-06
1547253,경상남도,1695,0,1695,0,2022-11-06
552522,울산광역시,768,0,767,1,2022-11-06
1128632,대구광역시,1706,0,1704,2,2022-11-06
340758,제주특별자치도,237,0,237,0,2022-11-06
1493171,인천광역시,2062,0,2062,0,2022-11-06
203229,세종특별자치시,317,0,317,0,2022-11-06
1494343,인천광역시,1172,0,1170,2,2022-11-07
1180901,경상북도,1054,0,1051,3,2022-11-07
750663,대전광역시,586,0,586,0,2022-11-07
5051319,서울특별시,3320,0,3320,0,2022-11-07
850778,전라남도,440,0,440,0,2022-11-07
756076,광주광역시,519,0,515,4,2022-11-07
766431,강원도,821,0,819,2,2022-11-07
203429,세종특별자치시,200,0,199,1,2022-11-07
552802,울산광역시,280,0,280,0,2022-11-07
1547991,경상남도,738,0,738,0,2022-11-07
872184,전라북도,482,0,482,0,2022-11-07
1524112,부산광역시,569,0,569,0,2022-11-07
1131995,대구광역시,2717,0,2712,5,2022-11-08
1527286,부산광역시,3174,0,3173,1,2022-11-08
553795,울산광역시,993,0,993,0,2022-11-08
813062,충청북도,1922,0,1922,0,2022-11-08
768420,강원도,1989,0,1989,0,2022-11-08
1042440,충청남도,2577,0,2577,0,2022-11-08
752894,대전광역시,2231,0,2231,0,2022-11-08
1550678,경상남도,2687,0,2685,2,2022-11-08
6988093,경기도,18232,0,18226,6,2022-11-08
1183329,경상북도,2428,0,2428,0,2022-11-08
5065477,서울특별시,14158,0,14157,1,2022-11-08
852241,전라남도,1463,0,1463,0,2022-11-08
873822,전라북도,1638,0,1638,0,2022-11-08
1498244,인천광역시,3901,0,3891,10,2022-11-08
341527,제주특별자치도,349,0,349,0,2022-11-09
770865,강원도,2445,0,2445,0,2022-11-09
7006617,경기도,18524,0,18514,10,2022-11-09
1502106,인천광역시,3862,0,3862,0,2022-11-09
853779,전라남도,1538,0,1537,1,2022-11-09
1044993,충청남도,2553,0,2553,0,2022-11-09
815353,충청북도,2291,0,2291,0,2022-11-09
754844,대전광역시,1950,0,1950,0,2022-11-09
554984,울산광역시,1189,0,1188,1,2022-11-09
1529989,부산광역시,2703,0,2701,2,2022-11-09
5077958,서울특별시,12481,0,12481,0,2022-11-09
1553509,경상남도,2831,0,2831,0,2022-11-09
875688,전라북도,1866,0,1866,0,2022-11-09
1186457,경상북도,3128,0,3122,6,2022-11-09
204552,세종특별자치시,465,0,465,0,2022-11-09
1134699,대구광역시,2704,0,2698,6,2022-11-09
7022891,경기도,16274,0,16267,7,2022-11-10
817344,충청북도,1991,0,1991,0,2022-11-10
1047216,충청남도,2223,0,2220,3,2022-11-10
1505360,인천광역시,3254,0,3251,3,2022-11-10
1189276,경상북도,2819,0,2819,0,2022-11-10
760325,광주광역시,1458,0,1457,1,2022-11-10
1532457,부산광역시,2468,0,2467,1,2022-11-10
556002,울산광역시,1018,0,1018,0,2022-11-10
5089031,서울특별시,11073,0,11071,2,2022-11-10
772777,강원도,1912,0,1912,0,2022-11-10
1556055,경상남도,2546,0,2545,1,2022-11-10
855199,전라남도,1420,0,1420,0,2022-11-10
1137207,대구광역시,2508,0,2504,4,2022-11-10
341891,제주특별자치도,364,0,364,0,2022-11-10
205072,세종특별자치시,520,0,520,0,2022-11-10
761611,광주광역시,1286,0,1286,0,2022-11-11
1139580,대구광역시,2373,0,2373,0,2022-11-11
7038702,경기도,15811,0,15809,2,2022-11-11
342238,제주특별자치도,347,0,345,2,2022-11-11
774745,강원도,1968,0,1967,1,2022-11-11
1049499,충청남도,2283,0,2282,1,2022-11-11
556987,울산광역시,985,0,985,0,2022-11-11
1535143,부산광역시,2686,0,2686,0,2022-11-11
856491,전라남도,1292,0,1292,0,2022-11-11
758415,대전광역시,1786,0,1783,3,2022-11-11
819185,충청북도,1841,0,1841,0,2022-11-11
205526,세종특별자치시,454,0,452,2,2022-11-11
206022,세종특별자치시,497,0,496,1,2022-11-12
342624,제주특별자치도,386,0,386,0,2022-11-12
1512189,인천광역시,3237,0,3235,2,2022-11-12
558006,울산광역시,1020,0,1020,0,2022-11-12
857905,전라남도,1414,0,1414,0,2022-11-12
821042,충청북도,1858,0,1857,1,2022-11-12
7053945,경기도,15283,0,15279,4,2022-11-12
1537898,부산광역시,2760,0,2760,0,2022-11-12
1561247,경상남도,2671,0,2670,1,2022-11-12
5110750,서울특별시,10836,0,10835,1,2022-11-12
1194676,경상북도,2706,0,2705,1,2022-11-12
776655,강원도,1910,0,1908,2,2022-11-12
1051843,충청남도,2350,0,2348,2,2022-11-12
880743,전라북도,1705,0,1705,0,2022-11-12
762941,광주광역시,1332,0,1332,0,2022-11-12
822726,충청북도,1684,0,1684,0,2022-11-13
206467,세종특별자치시,445,0,445,0,2022-11-13
761940,대전광역시,1632,0,1632,0,2022-11-13
5120013,서울특별시,9263,0,9262,1,2022-11-13
7067213,경기도,13268,0,13268,0,2022-11-13
1515038,인천광역시,2849,0,2847,2,2022-11-13
764461,광주광역시,1520,0,1520,0,2022-11-13
1053903,충청남도,2060,0,2060,0,2022-11-13
342951,제주특별자치도,327,0,327,0,2022-11-13
1197410,경상북도,2734,0,2731,3,2022-11-13
1144338,대구광역시,2330,0,2328,2,2022-11-13
762843,대전광역시,903,0,903,0,2022-11-14
883145,전라북도,634,0,634,0,2022-11-14
765153,광주광역시,692,0,692,0,2022-11-14
5123662,서울특별시,3649,0,3649,0,2022-11-14
1198678,경상북도,1268,0,1266,2,2022-11-14
1054969,충청남도,1066,0,1063,3,2022-11-14
206654,세종특별자치시,187,0,187,0,2022-11-14
1564847,경상남도,1279,0,1278,1,2022-11-14
1145384,대구광역시,1046,0,1046,0,2022-11-14
7074680,경기도,7467,0,7467,0,2022-11-14
859816,전라남도,591,0,590,1,2022-11-14
1516445,인천광역시,1407,0,1401,6,2022-11-14
559435,울산광역시,465,0,465,0,2022-11-14
1541214,부산광역시,951,0,950,1,2022-11-14
885194,전라북도,2049,0,2048,1,2022-11-15
766728,광주광역시,1575,0,1575,0,2022-11-15
1148637,대구광역시,3253,0,3252,1,2022-11-15
765454,대전광역시,2611,0,2609,2,2022-11-15
207288,세종특별자치시,634,0,634,0,2022-11-15
861617,전라남도,1801,0,1801,0,2022-11-15
560738,울산광역시,1303,0,1302,1,2022-11-15
781332,강원도,2131,0,2129,2,2022-11-15
5139201,서울특별시,15539,0,15538,1,2022-11-15
1568749,경상남도,3902,0,3900,2,2022-11-15
343495,제주특별자치도,309,0,308,1,2022-11-15
7095187,경기도,20507,0,20501,6,2022-11-15
1058049,충청남도,3080,0,3079,1,2022-11-15
1520898,인천광역시,4453,0,4453,0,2022-11-15
1201697,경상북도,3019,0,3011,8,2022-11-15
783803,강원도,2471,0,2463,8,2022-11-16
1060785,충청남도,2736,0,2735,1,2022-11-16
828094,충청북도,2306,0,2306,0,2022-11-16
5151684,서울특별시,12483,0,12479,4,2022-11-16
562011,울산광역시,1273,0,1273,0,2022-11-16
1549119,부산광역시,3364,0,3364,0,2022-11-16
343950,제주특별자치도,455,0,455,0,2022-11-16
1524725,인천광역시,3827,0,3824,3,2022-11-16
768665,광주광역시,1937,0,1937,0,2022-11-16
207815,세종특별자치시,527,0,525,2,2022-11-16
863389,전라남도,1772,0,1772,0,2022-11-16
7114212,경기도,19025,0,19023,2,2022-11-16
1151573,대구광역시,2936,0,2933,3,2022-11-16
5162530,서울특별시,10846,0,10845,1,2022-11-17
208265,세종특별자치시,450,0,450,0,2022-11-17
1063345,충청남도,2560,0,2560,0,2022-11-17
563145,울산광역시,1134,0,1133,1,2022-11-17
1153969,대구광역시,2396,0,2393,3,2022-11-17
1552084,부산광역시,2965,0,2965,0,2022-11-17
1208128,경상북도,2762,0,2762,0,2022-11-17
829932,충청북도,1838,0,1838,0,2022-11-17
785623,강원도,1820,0,1819,1,2022-11-17
344320,제주특별자치도,370,0,370,0,2022-11-17
1528040,인천광역시,3315,0,3315,0,2022-11-17
1574941,경상남도,2780,0,2777,3,2022-11-17
208670,세종특별자치시,405,0,405,0,2022-11-18
770910,대전광역시,1509,0,1509,0,2022-11-18
771591,광주광역시,1387,0,1387,0,2022-11-18
1530908,인천광역시,2868,0,2865,3,2022-11-18
890850,전라북도,1658,0,1658,0,2022-11-18
5172272,서울특별시,9742,0,9741,1,2022-11-18
7143975,경기도,14069,0,14063,6,2022-11-18
1554633,부산광역시,2549,0,2546,3,2022-11-18
1065364,충청남도,2019,0,2019,0,2022-11-18
344676,제주특별자치도,356,0,356,0,2022-11-18
787340,강원도,1717,0,1716,1,2022-11-18
831577,충청북도,1645,0,1644,1,2022-11-18
564019,울산광역시,874,0,873,1,2022-11-18
1156151,대구광역시,2182,0,2179,3,2022-11-18
7158272,경기도,14345,0,14333,12,2022-11-19
1067535,충청남도,2181,0,2180,1,2022-11-19
1580024,경상남도,2632,0,2630,2,2022-11-19
5182363,서울특별시,10124,0,10124,0,2022-11-19
1158405,대구광역시,2258,0,2255,3,2022-11-19
867324,전라남도,1241,0,1241,0,2022-11-19
1557415,부산광역시,2787,0,2787,0,2022-11-19
772537,대전광역시,1628,0,1627,1,2022-11-19
1213172,경상북도,2449,0,2449,0,2022-11-19
345015,제주특별자치도,340,0,340,0,2022-11-19
1533770,인천광역시,2880,0,2877,3,2022-11-19
892530,전라북도,1685,0,1685,0,2022-11-19
564954,울산광역시,938,0,937,1,2022-11-19
833210,충청북도,1638,0,1634,4,2022-11-19
209062,세종특별자치시,392,0,392,0,2022-11-19
772951,광주광역시,1360,0,1360,0,2022-11-19
5191167,서울특별시,8804,0,8804,0,2022-11-20
834814,충청북도,1604,0,1603,1,2022-11-20
868601,전라남도,1277,0,1277,0,2022-11-20
7170660,경기도,12388,0,12386,2,2022-11-20
1536562,인천광역시,2792,0,2789,3,2022-11-20
566031,울산광역시,1077,0,1077,0,2022-11-20
1582510,경상남도,2486,0,2485,1,2022-11-20
773980,대전광역시,1443,0,1443,0,2022-11-20
790378,강원도,1350,0,1349,1,2022-11-20
774426,광주광역시,1475,0,1475,0,2022-11-20
894229,전라북도,1699,0,1696,3,2022-11-20
1560038,부산광역시,2623,0,2623,0,2022-11-20
345369,제주특별자치도,354,0,354,0,2022-11-20
209750,세종특별자치시,256,0,256,0,2022-11-21
1537983,인천광역시,1421,0,1417,4,2022-11-21
774851,대전광역시,871,0,871,0,2022-11-21
869167,전라남도,566,0,566,0,2022-11-21
1561075,부산광역시,1037,0,1037,0,2022-11-21
1161488,대구광역시,1312,0,1310,2,2022-11-21
5194993,서울특별시,3826,0,3826,0,2022-11-21
345614,제주특별자치도,245,0,245,0,2022-11-21
1583640,경상남도,1130,0,1130,0,2022-11-21
894814,전라북도,585,0,585,0,2022-11-21
7177730,경기도,7070,0,7070,0,2022-11-21
566381,울산광역시,350,0,350,0,2022-11-21
791287,강원도,909,0,909,0,2022-11-21
1165011,대구광역시,3523,0,3519,4,2022-11-22
777247,대전광역시,2396,0,2393,3,2022-11-22
1542504,인천광역시,4521,0,4515,6,2022-11-22
1219622,경상북도,2744,0,2744,0,2022-11-22
567615,울산광역시,1234,0,1233,1,2022-11-22
837572,충청북도,2073,0,2073,0,2022-11-22
793304,강원도,2017,0,2012,5,2022-11-22
1587670,경상남도,4030,0,4029,1,2022-11-22
896932,전라북도,2118,0,2118,0,2022-11-22
7198458,경기도,20728,0,20721,7,2022-11-22
345943,제주특별자치도,329,0,327,2,2022-11-22
5210606,서울특별시,15613,0,15608,5,2022-11-22
871052,전라남도,1885,0,1883,2,2022-11-22
1073380,충청남도,2932,0,2931,1,2022-11-22
1223223,경상북도,3601,0,3599,2,2022-11-23
840030,충청북도,2458,0,2458,0,2022-11-23
1569694,부산광역시,4026,0,4025,1,2022-11-23
1546416,인천광역시,3912,0,3909,3,2022-11-23
1591486,경상남도,3816,0,3813,3,2022-11-23
795617,강원도,2313,0,2312,1,2022-11-23
779345,대전광역시,2098,0,2098,0,2022-11-23
210871,세종특별자치시,541,0,540,1,2022-11-23
5224105,서울특별시,13499,0,13499,0,2022-11-23
872924,전라남도,1872,0,1871,1,2022-11-23
1168001,대구광역시,2990,0,2980,10,2022-11-23
569037,울산광역시,1422,0,1420,2,2022-11-23
778668,광주광역시,2177,0,2176,1,2022-11-23
210871,세종특별자치시,424,0,424,0,2022-11-24
211295,세종특별자치시,424,0,424,0,2022-11-24
1572946,부산광역시,3252,0,3251,1,2022-11-24
570154,울산광역시,1117,0,1117,0,2022-11-24
840030,충청북도,1902,0,1902,0,2022-11-24
899180,전라북도,1901,0,1901,0,2022-11-24
795617,강원도,1830,0,1828,2,2022-11-24
5235561,서울특별시,11456,0,11455,1,2022-11-24
778668,광주광역시,1684,0,1684,0,2022-11-24
1594837,경상남도,3351,0,3351,0,2022-11-24
1546416,인천광역시,3558,0,3550,8,2022-11-24
779345,대전광역시,1878,0,1878,0,2022-11-24
1168001,대구광역시,2721,0,2719,2,2022-11-24
569037,울산광역시,1117,0,1117,0,2022-11-24
1549974,인천광역시,3558,0,3550,8,2022-11-24
5224105,서울특별시,11456,0,11455,1,2022-11-24
780352,광주광역시,1684,0,1684,0,2022-11-24
1223223,경상북도,2990,0,2986,4,2022-11-24
901081,전라북도,1901,0,1901,0,2022-11-24
7218261,경기도,16473,0,16468,5,2022-11-24
841932,충청북도,1902,0,1902,0,2022-11-24
1078931,충청남도,2479,0,2478,1,2022-11-24
1170722,대구광역시,2721,0,2719,2,2022-11-24
1226213,경상북도,2990,0,2986,4,2022-11-24
874604,전라남도,1680,0,1679,1,2022-11-24
1591486,경상남도,3351,0,3351,0,2022-11-24
346750,제주특별자치도,363,0,363,0,2022-11-24
7234734,경기도,16473,0,16468,5,2022-11-24
797447,강원도,1830,0,1828,2,2022-11-24
346387,제주특별자치도,363,0,363,0,2022-11-24
872924,전라남도,1680,0,1679,1,2022-11-24
1076452,충청남도,2479,0,2478,1,2022-11-24
211739,세종특별자치시,444,0,443,1,2022-11-25
5246245,서울특별시,10684,0,10684,0,2022-11-25
1553074,인천광역시,3100,0,3099,1,2022-11-25
782014,광주광역시,1662,0,1662,0,2022-11-25
1173024,대구광역시,2302,0,2296,6,2022-11-25
902790,전라북도,1709,0,1709,0,2022-11-25
1576118,부산광역시,3172,0,3172,0,2022-11-25
571057,울산광역시,903,0,901,2,2022-11-25
876081,전라남도,1477,0,1476,1,2022-11-25
782988,대전광역시,1765,0,1765,0,2022-11-25
1229034,경상북도,2821,0,2818,3,2022-11-25
799191,강원도,1744,0,1742,2,2022-11-25
1081140,충청남도,2209,0,2209,0,2022-11-25
347101,제주특별자치도,351,0,351,0,2022-11-25
1579101,부산광역시,2992,0,2992,0,2022-11-26
1600592,경상남도,2848,0,2847,1,2022-11-26
845327,충청북도,1767,0,1767,0,2022-11-26
212114,세종특별자치시,375,0,374,1,2022-11-26
783616,광주광역시,1604,0,1602,2,2022-11-26
1231655,경상북도,2626,0,2624,2,2022-11-26
572040,울산광역시,986,0,985,1,2022-11-26
904463,전라북도,1677,0,1676,1,2022-11-26
800826,강원도,1635,0,1634,1,2022-11-26
347415,제주특별자치도,314,0,313,1,2022-11-26
877551,전라남도,1474,0,1473,1,2022-11-26
1175517,대구광역시,2496,0,2492,4,2022-11-26
5256380,서울특별시,10161,0,10157,4,2022-11-26
784601,대전광역시,1617,0,1617,0,2022-11-26
1556201,인천광역시,3133,0,3130,3,2022-11-26
1083480,충청남도,2343,0,2342,1,2022-11-26
786111,대전광역시,1510,0,1510,0,2022-11-27
5265540,서울특별시,9160,0,9160,0,2022-11-27
212500,세종특별자치시,386,0,386,0,2022-11-27
846831,충청북도,1504,0,1504,0,2022-11-27
1177884,대구광역시,2367,0,2365,2,2022-11-27
1603164,경상남도,2572,0,2569,3,2022-11-27
572999,울산광역시,959,0,959,0,2022-11-27
1234118,경상북도,2463,0,2460,3,2022-11-27
785070,광주광역시,1454,0,1454,0,2022-11-27
347716,제주특별자치도,301,0,300,1,2022-11-27
878890,전라남도,1339,0,1334,5,2022-11-27
1558817,인천광역시,2616,0,2616,0,2022-11-27
1085400,충청남도,1920,0,1920,0,2022-11-27
7277164,경기도,12987,0,12984,3,2022-11-27
347935,제주특별자치도,219,0,219,0,2022-11-28
786931,대전광역시,820,0,820,0,2022-11-28
785828,광주광역시,758,0,758,0,2022-11-28
879547,전라남도,657,0,657,0,2022-11-28
802994,강원도,890,0,888,2,2022-11-28
1178608,대구광역시,724,0,723,1,2022-11-28
906868,전라북도,663,0,662,1,2022-11-28
1604424,경상남도,1260,0,1260,0,2022-11-28
1582490,부산광역시,971,0,970,1,2022-11-28
847556,충청북도,725,0,724,1,2022-11-28
212725,세종특별자치시,225,0,225,0,2022-11-28
1086341,충청남도,941,0,941,0,2022-11-28
5269334,서울특별시,3794,0,3793,1,2022-11-28
1235315,경상북도,1197,0,1197,0,2022-11-28
1560231,인천광역시,1414,0,1407,7,2022-11-28
908953,전라북도,2085,0,2085,0,2022-11-29
1089210,충청남도,2869,0,2868,1,2022-11-29
7303687,경기도,19832,0,19823,9,2022-11-29
1564400,인천광역시,4169,0,4166,3,2022-11-29
804950,강원도,1956,0,1955,1,2022-11-29
213240,세종특별자치시,515,0,514,1,2022-11-29
881647,전라남도,2100,0,2098,2,2022-11-29
789148,대전광역시,2217,0,2216,1,2022-11-29
1182109,대구광역시,3501,0,3493,8,2022-11-29
1587257,부산광역시,4767,0,4761,6,2022-11-29
787594,광주광역시,1766,0,1763,3,2022-11-29
849518,충청북도,1962,0,1962,0,2022-11-29
5284835,서울특별시,15501,0,15498,3,2022-11-29
1185135,대구광역시,3026,0,3022,4,2022-11-30
575890,울산광역시,1290,0,1286,4,2022-11-30
5297125,서울특별시,12290,0,12288,2,2022-11-30
807137,강원도,2187,0,2187,0,2022-11-30
789813,광주광역시,2219,0,2216,3,2022-11-30
348762,제주특별자치도,491,0,490,1,2022-11-30
1241668,경상북도,3682,0,3680,2,2022-11-30
1591055,부산광역시,3798,0,3797,1,2022-11-30
1092053,충청남도,2843,0,2841,2,2022-11-30
911228,전라북도,2275,0,2272,3,2022-11-30
851765,충청북도,2247,0,2245,2,2022-11-30
1612163,경상남도,3809,0,3806,3,2022-11-30
1568341,인천광역시,3941,0,3930,11,2022-11-30
213757,세종특별자치시,517,0,517,0,2022-11-30
7338470,경기도,15934,0,15932,2,2022-12-01
1594204,부산광역시,3149,0,3149,0,2022-12-01
1244524,경상북도,2856,0,2855,1,2022-12-01
577016,울산광역시,1126,0,1126,0,2022-12-01
913086,전라북도,1858,0,1858,0,2022-12-01
808860,강원도,1723,0,1721,2,2022-12-01
214215,세종특별자치시,458,0,458,0,2022-12-01
885073,전라남도,1560,0,1558,2,2022-12-01
792998,대전광역시,1803,0,1802,1,2022-12-01
5308159,서울특별시,11034,0,11032,2,2022-12-01
853584,충청북도,1819,0,1819,0,2022-12-01
1615347,경상남도,3184,0,3184,0,2022-12-01
349139,제주특별자치도,377,0,376,1,2022-12-01
1094444,충청남도,2391,0,2391,0,2022-12-01
791655,광주광역시,1842,0,1842,0,2022-12-01
1571718,인천광역시,3377,0,3374,3,2022-12-01
577998,울산광역시,982,0,979,3,2022-12-02
793272,광주광역시,1617,0,1616,1,2022-12-02
855269,충청북도,1685,0,1685,0,2022-12-02
1247116,경상북도,2592,0,2590,2,2022-12-02
349494,제주특별자치도,355,0,354,1,2022-12-02
794691,대전광역시,1693,0,1691,2,2022-12-02
1597132,부산광역시,2928,0,2927,1,2022-12-02
1618087,경상남도,2740,0,2739,1,2022-12-02
7353498,경기도,15028,0,15023,5,2022-12-02
214578,세종특별자치시,363,0,363,0,2022-12-02
1574807,인천광역시,3089,0,3088,1,2022-12-02
914757,전라북도,1671,0,1671,0,2022-12-02
1096521,충청남도,2077,0,2077,0,2022-12-02
1190106,대구광역시,2407,0,2405,2,2022-12-02
1599876,부산광역시,2755,0,2755,0,2022-12-03
1192470,대구광역시,2372,0,2369,3,2022-12-03
888338,전라남도,1614,0,1612,2,2022-12-03
215050,세종특별자치시,473,0,473,0,2022-12-03
1249689,경상북도,2575,0,2572,3,2022-12-03
578914,울산광역시,918,0,913,5,2022-12-03
856995,충청북도,1727,0,1727,0,2022-12-03
5328989,서울특별시,10369,0,10368,1,2022-12-03
812021,강원도,1577,0,1577,0,2022-12-03
1577901,인천광역시,3107,0,3107,0,2022-12-03
796356,대전광역시,1667,0,1667,0,2022-12-03
7368261,경기도,14807,0,14804,3,2022-12-03
349841,제주특별자치도,348,0,348,0,2022-12-03
813163,강원도,1142,0,1141,1,2022-12-04
1580609,인천광역시,2708,0,2707,1,2022-12-04
350200,제주특별자치도,359,0,359,0,2022-12-04
797823,대전광역시,1467,0,1466,1,2022-12-04
889780,전라남도,1442,0,1441,1,2022-12-04
5337515,서울특별시,8526,0,8526,0,2022-12-04
1194797,대구광역시,2327,0,2321,6,2022-12-04
1252062,경상북도,2373,0,2373,0,2022-12-04
1602330,부산광역시,2454,0,2449,5,2022-12-04
918323,전라북도,1826,0,1824,2,2022-12-04
7381114,경기도,12853,0,12850,3,2022-12-04
1100702,충청남도,1918,0,1918,0,2022-12-04
858610,충청북도,1615,0,1615,0,2022-12-04
215515,세종특별자치시,465,0,465,0,2022-12-04
918980,전라북도,657,0,656,1,2022-12-05
1624441,경상남도,1175,0,1175,0,2022-12-05
797569,광주광역시,818,0,817,1,2022-12-05
798597,대전광역시,774,0,772,2,2022-12-05
580216,울산광역시,419,0,418,1,2022-12-05
7388494,경기도,7380,0,7379,1,2022-12-05
5341436,서울특별시,3921,0,3920,1,2022-12-05
859357,충청북도,747,0,746,1,2022-12-05
813899,강원도,736,0,734,2,2022-12-05
1253195,경상북도,1133,0,1131,2,2022-12-05
350433,제주특별자치도,233,0,232,1,2022-12-05
1195491,대구광역시,694,0,693,1,2022-12-05
1101717,충청남도,1015,0,1015,0,2022-12-05
1582016,인천광역시,1407,0,1407,0,2022-12-05
890526,전라남도,746,0,746,0,2022-12-05
350796,제주특별자치도,363,0,363,0,2022-12-06
801185,대전광역시,2588,0,2588,0,2022-12-06
1255935,경상북도,2740,0,2735,5,2022-12-06
216404,세종특별자치시,640,0,640,0,2022-12-06
815920,강원도,2021,0,2020,1,2022-12-06
861415,충청북도,2058,0,2056,2,2022-12-06
921295,전라북도,2315,0,2313,2,2022-12-06
1608178,부산광역시,4856,0,4851,5,2022-12-06
1104884,충청남도,3167,0,3167,0,2022-12-06
892995,전라남도,2469,0,2468,1,2022-12-06
1586533,인천광역시,4517,0,4509,8,2022-12-06
1628656,경상남도,4215,0,4212,3,2022-12-06
799589,광주광역시,2020,0,2019,1,2022-12-06
581546,울산광역시,1330,0,1328,2,2022-12-06
351468,제주특별자치도,672,0,672,0,2022-12-07
863953,충청북도,2538,0,2537,1,2022-12-07
582992,울산광역시,1446,0,1443,3,2022-12-07
1590893,인천광역시,4360,0,4359,1,2022-12-07
1612140,부산광역시,3962,0,3962,0,2022-12-07
5371555,서울특별시,13747,0,13745,2,2022-12-07
1259588,경상북도,3653,0,3648,5,2022-12-07
217052,세종특별자치시,648,0,648,0,2022-12-07
1632820,경상남도,4164,0,4162,2,2022-12-07
802140,광주광역시,2551,0,2549,2,2022-12-07
1202563,대구광역시,3312,0,3305,7,2022-12-07
1108003,충청남도,3119,0,3117,2,2022-12-07
803425,대전광역시,2240,0,2240,0,2022-12-07
7431956,경기도,21330,0,21326,4,2022-12-07
923812,전라북도,2517,0,2514,3,2022-12-07
1594735,인천광역시,3842,0,3837,5,2022-12-08
1110829,충청남도,2826,0,2825,1,2022-12-08
1616068,부산광역시,3928,0,3928,0,2022-12-08
1205642,대구광역시,3079,0,3077,2,2022-12-08
352047,제주특별자치도,579,0,578,1,2022-12-08
584227,울산광역시,1235,0,1234,1,2022-12-08
1636415,경상남도,3595,0,3595,0,2022-12-08
804404,광주광역시,2264,0,2264,0,2022-12-08
925863,전라북도,2051,0,2051,0,2022-12-08
805373,대전광역시,1948,0,1948,0,2022-12-08
866128,충청북도,2175,0,2175,0,2022-12-08
1262558,경상북도,2970,0,2968,2,2022-12-08
897281,전라남도,2037,0,2035,2,2022-12-08
7450242,경기도,18286,0,18283,3,2022-12-08
218151,세종특별자치시,522,0,522,0,2022-12-09
585499,울산광역시,1272,0,1270,2,2022-12-09
1113685,충청남도,2856,0,2855,1,2022-12-09
5395385,서울특별시,11853,0,11852,1,2022-12-09
1265356,경상북도,2798,0,2795,3,2022-12-09
868027,충청북도,1899,0,1899,0,2022-12-09
7467881,경기도,17639,0,17633,6,2022-12-09
821706,강원도,1748,0,1748,0,2022-12-09
1208424,대구광역시,2782,0,2775,7,2022-12-09
806480,광주광역시,2076,0,2076,0,2022-12-09
899281,전라남도,2000,0,1998,2,2022-12-09
807221,대전광역시,1848,0,1847,1,2022-12-09
1639822,경상남도,3407,0,3406,1,2022-12-09
1116407,충청남도,2730,0,2729,1,2022-12-10
353098,제주특별자치도,477,0,477,0,2022-12-10
586737,울산광역시,1238,0,1236,2,2022-12-10
1267957,경상북도,2602,0,2601,1,2022-12-10
901244,전라남도,1963,0,1960,3,2022-12-10
1602245,인천광역시,3925,0,3924,1,2022-12-10
809010,대전광역시,1789,0,1789,0,2022-12-10
808524,광주광역시,2044,0,2044,0,2022-12-10
218697,세종특별자치시,548,0,548,0,2022-12-10
1623676,부산광역시,3834,0,3830,4,2022-12-10
823493,강원도,1787,0,1786,1,2022-12-10
870091,충청북도,2070,0,2070,0,2022-12-10
5407043,서울특별시,11690,0,11689,1,2022-12-10
7485368,경기도,17525,0,17518,7,2022-12-10
1211213,대구광역시,2795,0,2792,3,2022-12-10
219208,세종특별자치시,511,0,511,0,2022-12-11
824831,강원도,1338,0,1337,1,2022-12-11
931892,전라북도,2053,0,2053,0,2022-12-11
810418,광주광역시,1894,0,1892,2,2022-12-11
7500128,경기도,14760,0,14759,1,2022-12-11
1626972,부산광역시,3296,0,3295,1,2022-12-11
1605638,인천광역시,3393,0,3393,0,2022-12-11
902924,전라남도,1680,0,1680,0,2022-12-11
353613,제주특별자치도,515,0,515,0,2022-12-11
587952,울산광역시,1215,0,1215,0,2022-12-11
810599,대전광역시,1589,0,1589,0,2022-12-11
872028,충청북도,1937,0,1937,0,2022-12-11
1213494,대구광역시,2281,0,2275,6,2022-12-11
1646832,경상남도,3256,0,3256,0,2022-12-11
1270665,경상북도,2708,0,2708,0,2022-12-11
219414,세종특별자치시,206,0,206,0,2022-12-12
825811,강원도,980,0,980,0,2022-12-12
1628086,부산광역시,1114,0,1114,0,2022-12-12
932612,전라북도,720,0,720,0,2022-12-12
354009,제주특별자치도,396,0,394,2,2022-12-12
7508144,경기도,8016,0,8015,1,2022-12-12
903908,전라남도,984,0,982,2,2022-12-12
1271955,경상북도,1290,0,1289,1,2022-12-12
5420556,서울특별시,3910,0,3910,0,2022-12-12
1648308,경상남도,1476,0,1476,0,2022-12-12
811367,대전광역시,768,0,766,2,2022-12-12
811371,광주광역시,953,0,953,0,2022-12-12
872839,충청북도,811,0,810,1,2022-12-12
588470,울산광역시,518,0,517,1,2022-12-12
5438252,서울특별시,17696,0,17693,3,2022-12-13
934990,전라북도,2378,0,2378,0,2022-12-13
1123394,충청남도,3581,0,3578,3,2022-12-13
220184,세종특별자치시,770,0,770,0,2022-12-13
828021,강원도,2210,0,2209,1,2022-12-13
354394,제주특별자치도,385,0,385,0,2022-12-13
1612688,인천광역시,5507,0,5505,2,2022-12-13
813998,대전광역시,2631,0,2631,0,2022-12-13
813711,광주광역시,2340,0,2338,2,2022-12-13
1653612,경상남도,5304,0,5302,2,2022-12-13
906670,전라남도,2762,0,2762,0,2022-12-13
1634322,부산광역시,6236,0,6236,0,2022-12-13
7532239,경기도,24095,0,24093,2,2022-12-13
875153,충청북도,2314,0,2313,1,2022-12-13
592176,울산광역시,1925,0,1924,1,2022-12-14
1221924,대구광역시,3701,0,3695,6,2022-12-14
816581,광주광역시,2870,0,2868,2,2022-12-14
220812,세종특별자치시,628,0,628,0,2022-12-14
937801,전라북도,2811,0,2811,0,2022-12-14
1639744,부산광역시,5422,0,5420,2,2022-12-14
909418,전라남도,2748,0,2743,5,2022-12-14
877887,충청북도,2734,0,2732,2,2022-12-14
1658783,경상남도,5171,0,5170,1,2022-12-14
1617753,인천광역시,5065,0,5061,4,2022-12-14
7555432,경기도,23193,0,23177,16,2022-12-14
5453432,서울특별시,15180,0,15177,3,2022-12-14
1127097,충청남도,3703,0,3702,1,2022-12-14
1278567,경상북도,3733,0,3731,2,2022-12-14
1281842,경상북도,3275,0,3270,5,2022-12-15
355805,제주특별자치도,637,0,637,0,2022-12-15
593697,울산광역시,1521,0,1521,0,2022-12-15
818354,대전광역시,2005,0,2004,1,2022-12-15
221399,세종특별자치시,587,0,587,0,2022-12-15
5466262,서울특별시,12830,0,12830,0,2022-12-15
1621948,인천광역시,4195,0,4195,0,2022-12-15
1663183,경상남도,4400,0,4399,1,2022-12-15
1644413,부산광역시,4669,0,4668,1,2022-12-15
911740,전라남도,2322,0,2322,0,2022-12-15
7574461,경기도,19029,0,19023,6,2022-12-15
1225011,대구광역시,3087,0,3079,8,2022-12-15
940055,전라북도,2254,0,2254,0,2022-12-15
356395,제주특별자치도,590,0,590,0,2022-12-16
881970,충청북도,2004,0,2004,0,2022-12-16
942167,전라북도,2112,0,2111,1,2022-12-16
1626062,인천광역시,4114,0,4109,5,2022-12-16
821172,광주광역시,2266,0,2264,2,2022-12-16
1227880,대구광역시,2869,0,2862,7,2022-12-16
913945,전라남도,2205,0,2205,0,2022-12-16
595125,울산광역시,1428,0,1428,0,2022-12-16
1667327,경상남도,4144,0,4142,2,2022-12-16
1284522,경상북도,2680,0,2680,0,2022-12-16
221895,세종특별자치시,496,0,495,1,2022-12-16
1648717,부산광역시,4304,0,4303,1,2022-12-16
820356,대전광역시,2002,0,2002,0,2022-12-16
5478664,서울특별시,12402,0,12399,3,2022-12-16
836197,강원도,1811,0,1811,0,2022-12-17
222493,세종특별자치시,598,0,598,0,2022-12-17
356995,제주특별자치도,600,0,597,3,2022-12-17
822288,대전광역시,1941,0,1941,0,2022-12-17
916258,전라남도,2315,0,2309,6,2022-12-17
7610917,경기도,18028,0,18021,7,2022-12-17
1630099,인천광역시,4053,0,4053,0,2022-12-17
1230955,대구광역시,3078,0,3069,9,2022-12-17
5491015,서울특별시,12404,0,12402,2,2022-12-17
1652940,부산광역시,4229,0,4229,0,2022-12-17
884139,충청북도,2177,0,2177,0,2022-12-17
1135808,충청남도,2822,0,2822,0,2022-12-17
1287310,경상북도,2793,0,2793,0,2022-12-17
944407,전라북도,2243,0,2243,0,2022-12-17
1671628,경상남도,4304,0,4302,2,2022-12-17
823273,광주광역시,2105,0,2104,1,2022-12-17
837617,강원도,1420,0,1420,0,2022-12-18
1675225,경상남도,3597,0,3596,1,2022-12-18
357600,제주특별자치도,605,0,605,0,2022-12-18
823902,대전광역시,1614,0,1612,2,2022-12-18
597881,울산광역시,1352,0,1352,0,2022-12-18
1633635,인천광역시,3536,0,3526,10,2022-12-18
825349,광주광역시,2076,0,2075,1,2022-12-18
918149,전라남도,1891,0,1877,14,2022-12-18
885942,충청북도,1803,0,1803,0,2022-12-18
946595,전라북도,2188,0,2188,0,2022-12-18
1290010,경상북도,2700,0,2698,2,2022-12-18
223017,세종특별자치시,524,0,524,0,2022-12-18
7626725,경기도,15808,0,15804,4,2022-12-18
1233677,대구광역시,2722,0,2716,6,2022-12-18
5501664,서울특별시,10649,0,10647,2,2022-12-18
1138301,충청남도,2493,0,2492,1,2022-12-18
1657997,부산광역시,1213,0,1213,0,2022-12-19
838538,강원도,921,0,921,0,2022-12-19
1635185,인천광역시,1550,0,1547,3,2022-12-19
358003,제주특별자치도,403,0,403,0,2022-12-19
826195,광주광역시,846,0,846,0,2022-12-19
598446,울산광역시,565,0,565,0,2022-12-19
1234650,대구광역시,973,0,972,1,2022-12-19
1676901,경상남도,1676,0,1675,1,2022-12-19
1139406,충청남도,1105,0,1105,0,2022-12-19
1291380,경상북도,1370,0,1366,4,2022-12-19
5505855,서울특별시,4191,0,4191,0,2022-12-19
7634760,경기도,8035,0,8035,0,2022-12-19
824703,대전광역시,801,0,801,0,2022-12-19
947375,전라북도,780,0,780,0,2022-12-19
889286,충청북도,2302,0,2301,1,2022-12-20
1664562,부산광역시,6565,0,6563,2,2022-12-20
224036,세종특별자치시,796,0,796,0,2022-12-20
5524078,서울특별시,18223,0,18221,2,2022-12-20
1294128,경상북도,2748,0,2748,0,2022-12-20
7659390,경기도,24630,0,24624,6,2022-12-20
949679,전라북도,2304,0,2304,0,2022-12-20
600164,울산광역시,1718,0,1717,1,2022-12-20
922201,전라남도,3165,0,3147,18,2022-12-20
1142826,충청남도,3420,0,3419,1,2022-12-20
1640807,인천광역시,5622,0,5617,5,2022-12-20
1238275,대구광역시,3625,0,3619,6,2022-12-20
358405,제주특별자치도,402,0,402,0,2022-12-20
1682369,경상남도,5468,0,5466,2,2022-12-20
828169,광주광역시,1974,0,1974,0,2022-12-20
1146627,충청남도,3801,0,3800,1,2022-12-21
7683132,경기도,23742,0,23741,1,2022-12-21
1646104,인천광역시,5297,0,5297,0,2022-12-21
1670062,부산광역시,5500,0,5500,0,2022-12-21
1241891,대구광역시,3616,0,3609,7,2022-12-21
224766,세종특별자치시,730,0,729,1,2022-12-21
1688385,경상남도,6016,0,6013,3,2022-12-21
829712,대전광역시,2365,0,2364,1,2022-12-21
602221,울산광역시,2057,0,2055,2,2022-12-21
842949,강원도,2487,0,2486,1,2022-12-21
925288,전라남도,3087,0,3077,10,2022-12-21
830994,광주광역시,2825,0,2823,2,2022-12-21
892327,충청북도,3041,0,3041,0,2022-12-21
5539642,서울특별시,15564,0,15563,1,2022-12-21
952843,전라북도,3164,0,3163,1,2022-12-21
833366,광주광역시,2372,0,2368,4,2022-12-22
844896,강원도,1947,0,1947,0,2022-12-22
1650316,인천광역시,4212,0,4205,7,2022-12-22
603971,울산광역시,1750,0,1746,4,2022-12-22
360064,제주특별자치도,714,0,713,1,2022-12-22
831891,대전광역시,2179,0,2179,0,2022-12-22
225403,세종특별자치시,637,0,637,0,2022-12-22
927965,전라남도,2677,0,2668,9,2022-12-22
1693109,경상남도,4724,0,4724,0,2022-12-22
5553588,서울특별시,13946,0,13944,2,2022-12-22
1301329,경상북도,3300,0,3297,3,2022-12-22
894622,충청북도,2295,0,2295,0,2022-12-22
1149770,충청남도,3143,0,3141,2,2022-12-22
1152423,충청남도,2653,0,2651,2,2022-12-23
7722859,경기도,18800,0,18798,2,2022-12-23
835356,광주광역시,1990,0,1990,0,2022-12-23
1679934,부산광역시,4733,0,4733,0,2022-12-23
1697663,경상남도,4554,0,4554,0,2022-12-23
1247745,대구광역시,2657,0,2643,14,2022-12-23
930354,전라남도,2389,0,2369,20,2022-12-23
225960,세종특별자치시,557,0,557,0,2022-12-23
360824,제주특별자치도,760,0,759,1,2022-12-23
5566002,서울특별시,12414,0,12411,3,2022-12-23
1654634,인천광역시,4318,0,4316,2,2022-12-23
896558,충청북도,1936,0,1936,0,2022-12-23
605518,울산광역시,1547,0,1545,2,2022-12-23
1250573,대구광역시,2832,0,2828,4,2022-12-24
959569,전라북도,1896,0,1896,0,2022-12-24
1702123,경상남도,4462,0,4462,0,2022-12-24
1658392,인천광역시,3766,0,3764,2,2022-12-24
5578034,서울특별시,12083,0,12080,3,2022-12-24
607185,울산광역시,1668,0,1668,0,2022-12-24
1684669,부산광역시,4746,0,4744,2,2022-12-24
1307091,경상북도,2934,0,2933,1,2022-12-24
7741381,경기도,18575,0,18571,4,2022-12-24
932347,전라남도,1997,0,1986,11,2022-12-24
835697,대전광역시,1822,0,1820,2,2022-12-24
226542,세종특별자치시,582,0,582,0,2022-12-24
837256,광주광역시,1901,0,1900,1,2022-12-24
848321,강원도,1710,0,1710,0,2022-12-24
361414,제주특별자치도,591,0,590,1,2022-12-24
898575,충청북도,2021,0,2018,3,2022-12-24
1155006,충청남도,2593,0,2593,0,2022-12-24
227067,세종특별자치시,525,0,525,0,2022-12-25
1253059,대구광역시,2486,0,2482,4,2022-12-25
608662,울산광역시,1477,0,1477,0,2022-12-25
961425,전라북도,1856,0,1856,0,2022-12-25
1662030,인천광역시,3638,0,3638,0,2022-12-25
7757826,경기도,16445,0,16439,6,2022-12-25
934115,전라남도,1768,0,1764,4,2022-12-25
361974,제주특별자치도,560,0,560,0,2022-12-25
849583,강원도,1262,0,1261,1,2022-12-25
1157343,충청남도,2337,0,2336,1,2022-12-25
900403,충청북도,1828,0,1827,1,2022-12-25
1705862,경상남도,3739,0,3737,2,2022-12-25
1311026,경상북도,1359,0,1359,0,2022-12-26
1158346,충청남도,1003,0,1003,0,2022-12-26
7765572,경기도,7746,0,7745,1,2022-12-26
5592127,서울특별시,3585,0,3584,1,2022-12-26
362375,제주특별자치도,401,0,401,0,2022-12-26
1689876,부산광역시,1216,0,1216,0,2022-12-26
838166,대전광역시,765,0,754,11,2022-12-26
850461,강원도,878,0,877,1,2022-12-26
1253904,대구광역시,845,0,843,2,2022-12-26
1707847,경상남도,1985,0,1985,0,2022-12-26
227272,세종특별자치시,205,0,205,0,2022-12-26
839695,광주광역시,730,0,730,0,2022-12-26
609278,울산광역시,616,0,616,0,2022-12-26
1663581,인천광역시,1551,0,1551,0,2022-12-26
901184,충청북도,781,0,780,1,2022-12-26
903347,충청북도,2163,0,2163,0,2022-12-27
841430,광주광역시,1735,0,1735,0,2022-12-27
964506,전라북도,2188,0,2187,1,2022-12-27
5610852,서울특별시,18725,0,18723,2,2022-12-27
7789934,경기도,24362,0,24356,6,2022-12-27
1313757,경상북도,2731,0,2730,1,2022-12-27
611041,울산광역시,1763,0,1763,0,2022-12-27
938106,전라남도,3049,0,3047,2,2022-12-27
1669280,인천광역시,5699,0,5699,0,2022-12-27
362920,제주특별자치도,545,0,545,0,2022-12-27
1161843,충청남도,3497,0,3497,0,2022-12-27
1257368,대구광역시,3464,0,3458,6,2022-12-27
1713421,경상남도,5574,0,5573,1,2022-12-27
1696702,부산광역시,6826,0,6824,2,2022-12-27
852398,강원도,1937,0,1934,3,2022-12-27
228005,세종특별자치시,733,0,733,0,2022-12-27
906103,충청북도,2756,0,2755,1,2022-12-28
613303,울산광역시,2262,0,2261,1,2022-12-28
1702845,부산광역시,6143,0,6141,2,2022-12-28
1260890,대구광역시,3522,0,3510,12,2022-12-28
7814056,경기도,24122,0,24111,11,2022-12-28
967031,전라북도,2525,0,2525,0,2022-12-28
843929,광주광역시,2499,0,2496,3,2022-12-28
843077,대전광역시,2348,0,2348,0,2022-12-28
940880,전라남도,2774,0,2774,0,2022-12-28
1317639,경상북도,3882,0,3882,0,2022-12-28
1674382,인천광역시,5102,0,5102,0,2022-12-28
1165475,충청남도,3632,0,3631,1,2022-12-28
1719605,경상남도,6184,0,6183,1,2022-12-28
363915,제주특별자치도,995,0,994,1,2022-12-28
228690,세종특별자치시,685,0,685,0,2022-12-28
1168371,충청남도,2896,0,2895,1,2022-12-29
845070,대전광역시,1993,0,1990,3,2022-12-29
229295,세종특별자치시,605,0,604,1,2022-12-29
856549,강원도,1871,0,1870,1,2022-12-29
845796,광주광역시,1867,0,1867,0,2022-12-29
969117,전라북도,2086,0,2086,0,2022-12-29
943235,전라남도,2355,0,2355,0,2022-12-29
1320846,경상북도,3207,0,3205,2,2022-12-29
615101,울산광역시,1798,0,1797,1,2022-12-29
1678749,인천광역시,4367,0,4366,1,2022-12-29
1263538,대구광역시,2648,0,2646,2,2022-12-29
1724270,경상남도,4665,0,4665,0,2022-12-29
1707682,부산광역시,4837,0,4837,0,2022-12-29
7833713,경기도,19657,0,19655,2,2022-12-29
908476,충청북도,2373,0,2372,1,2022-12-29
5640031,서울특별시,13396,0,13396,0,2022-12-29
364664,제주특별자치도,749,0,749,0,2022-12-29
229758,세종특별자치시,463,0,463,0,2022-12-30
1171143,충청남도,2772,0,2772,0,2022-12-30
846880,대전광역시,1810,0,1809,1,2022-12-30
971081,전라북도,1964,0,1964,0,2022-12-30
616598,울산광역시,1497,0,1493,4,2022-12-30
858222,강원도,1673,0,1671,2,2022-12-30
365270,제주특별자치도,606,0,605,1,2022-12-30
5651699,서울특별시,11668,0,11665,3,2022-12-30
945410,전라남도,2175,0,2175,0,2022-12-30
1266241,대구광역시,2703,0,2700,3,2022-12-30
1682904,인천광역시,4155,0,4151,4,2022-12-30
1323710,경상북도,2864,0,2863,1,2022-12-30
847447,광주광역시,1651,0,1651,0,2022-12-30
859851,강원도,1630,0,1630,0,2022-12-31
7868406,경기도,16799,0,16794,5,2022-12-31
1733021,경상남도,4344,0,4342,2,2022-12-31
1716966,부산광역시,4502,0,4501,1,2022-12-31
1268852,대구광역시,2614,0,2610,4,2022-12-31
618200,울산광역시,1604,0,1603,1,2022-12-31
912347,충청북도,1865,0,1865,0,2022-12-31
972878,전라북도,1799,0,1798,1,2022-12-31
1326714,경상북도,3006,0,3003,3,2022-12-31
848620,대전광역시,1745,0,1745,0,2022-12-31
5663251,서울특별시,11601,0,11597,4,2022-12-31
1686864,인천광역시,3976,0,3975,1,2022-12-31
365960,제주특별자치도,691,0,691,0,2022-12-31
849060,광주광역시,1615,0,1612,3,2022-12-31
947524,전라남도,2117,0,2116,1,2022-12-31
